# [Filetype: Wrye Mash Remover]
# Banners and signs from the Bethesda master files.
# by Dragon32

# Bethesda Banners and Signs
"Act_banner_Ald_Velothi"	"Ald Velothi"
"Act_banner_Gnaar_Mok"	"Gnaar Mok"
"Act_banner_Hla_Oad"	"Hla Oad"
"Act_banner_Khuul"	"Khuul"
"Act_banner_Sadrith_Mora"	"Sadrith Mora"
"Act_banner_Tel_Aruhn"	"Tel Aruhn"
"Act_banner_Tel_Branora"	"Tel Branora"
"Act_banner_Tel_Fyr"	"Tel Fyr"
"Act_banner_Tel_Mora"	"Tel Mora"
"Act_banner_Tel_Vos"	"Tel Vos"
"Act_banner_Vos"	"Vos"
"active_sign_ald-ruhn_01"	"Ald-ruhn"
"active_sign_ald-ruhn_02"	"Ald-ruhn"
"active_sign_ald-ruhnB_01"	"Ald-ruhn (back road)"
"active_sign_ald-ruhnM_01"	"Ald-ruhn (main road)"
"active_sign_aldvelothi_01"	"Ald Velothi"
"active_sign_balmora_01"	"Balmora"
"active_sign_balmora_02"	"Balmora"
"active_sign_buckmoth_01"	"Buckmoth Legion Fort"
"active_sign_buckmoth_02"	"Buckmoth Legion Fort"
"active_sign_buckmothB_01"	"Buckmoth Fort (back road)"
"active_sign_buckmothM_01"	"Buckmoth Fort (main road)"
"active_sign_c_alchemy_01"	"Imperial Alchemy"
"active_sign_c_arms_01"	"Imperial Arms"
"active_sign_c_arms_02"	"Imperial Arms"
"active_sign_c_arms_caldera"	"Hodlismod: Armorer"
"active_sign_c_clothing_01"	"Falanaamo: Clothier"
"active_sign_c_clothing_falanaam"	"Falanaamo: Clothier"
"active_sign_c_goods_01"	"Verick Germain: Trader"
"active_sign_c_goods_02"	"Imperial Goods"
"active_sign_c_goods_caldera"	"Verick Germain: Trader"
"active_sign_c_goods_heifnir"	"Heifnir: Trader"
"active_sign_c_goods_mebestien"	"Mebestien's Supplies"
"active_sign_c_guildf_01"	"Fighters' Guild"
"active_sign_c_guildm_01"	"Mages' Guild"
"active_sign_c_guildm_caldera"	"Mages' Guild Caldera"
"active_sign_c_inn_02"	"Six Fishes"
"active_sign_c_inn_shenks"	"Shenk's Shovel"
"active_sign_c_pawn_01"	"Sign"
"active_sign_c_pawn_irgola"	"Irgola: Pawnbroker"
"active_sign_cal_mine_02"	"Caldera Mining Company"
"active_sign_caldera_01"	"Caldera"
"active_sign_caldera_02"	"Caldera"
"active_sign_dagon_fel_01"	"Dagon Fel"
"active_sign_dagon_fell_01"	"Dagon Fell"
"active_sign_ebonheart_01"	"Ebonheart"
"active_sign_ebonheart_02"	"Ebonheart"
"active_sign_ghostgate_01"	"Ghostgate"
"active_sign_gnaar _mok_01"	"Gnaar Mok"
"active_sign_gnaar_mok_02"	"Gnaar Mok"
"active_sign_gnisis_01"	"Gnisis"
"active_sign_guartrail_01"	"Guar Trail"
"active_sign_hla_oad_01"	"Hla Oad"
"active_sign_hla_oad_02"	"Hla Oad"
"active_sign_Khuul_01"	"Khuul"
"active_sign_maar_gan_01"	"Maar Gan"
"active_sign_maar_gan_02"	"Maar Gan"
"active_sign_maar_ganB_02"	"Maar gan (back road)"
"active_sign_maar_ganM_02"	"Maar gan (main road)"
"active_sign_Molag_Mar_01"	"Molag Mar"
"active_sign_moonmoth_01"	"Moonmoth Legion Fort"
"active_sign_Mt_A_01"	"Mount Assarnibibi"
"active_sign_Mt_Kand_01"	"Mount Kand"
"active_sign_pelagiad_01"	"Pelagiad"
"active_sign_pelagiad_02"	"Pelagiad"
"active_sign_pelagiadB_01"	"Pelagiad (back road)"
"active_sign_pelagiadM_01"	"Pelagiad (main road)"
"active_sign_seydaneen_01"	"Seyda Neen"
"active_sign_seydaneen_02"	"Seyda Neen"
"active_sign_suran_01"	"Suran"
"active_sign_Tel_Vos_01"	"Tel Vos"
"active_sign_vivec_01"	"Vivec"
"active_sign_vivec_02"	"Vivec"
"active_sign_Vos_01"	"Vos"
"active_signpost_01"	
"active_signpost_02"	
"Ex_aldruhn_roadmarker_01"	"Ald-ruhn"
"ex_ashl_a_banner"	
"ex_ashl_a_banner_r"	
"ex_ashl_e_banner"	
"ex_ashl_e_banner_r"	
"ex_ashl_u_banner"	
"ex_ashl_u_banner_r"	
"ex_ashl_z_banner"	
"ex_ashl_z_banner_r"	
"Ex_balmora_roadmarker_01"	"Balmora"
"Ex_Gnisis_roadmarkern_01"	"Gnisis"
"Ex_maargan_roadmarker_01"	"Maar Gan"
"Ex_molagmar_roadmarker_01"	"Molag Mar"
"Ex_suran_roadmarker_01"	"Suran"
"Ex_V_ban_arena_01"	
"Ex_V_ban_avs_01"	
"Ex_V_ban_child_01"	
"Ex_V_ban_comfort_01"	
"Ex_V_ban_count_01"	
"Ex_V_ban_faith_01"	
"Ex_V_ban_hlaalu_01"	
"Ex_V_ban_imp_01"	
"Ex_V_ban_redoran_01"	
"Ex_V_ban_serving_01"	
"Ex_V_ban_speak_01"	
"Ex_V_ban_stdeyln_01"	
"Ex_V_ban_stolms_01"	
"Ex_V_ban_telvanni_01"	
"Ex_V_ban_tribunal_01"	
"Ex_V_ban_vivec_01"	
"Ex_V_ban_vivec_02"	
"Ex_V_ban_walk_01"	
"ex_v_banner_01"	
"ex_v_banner_02"	
"ex_v_banner_03"	
"Ex_V_sign_arena_01"	"Arena Canton"
"Ex_V_sign_fq_01"	"Foreign Quarter"
"Ex_V_sign_hallj_01"	"Hall of Justice"
"Ex_V_sign_hallw_01"	"Hall of Wisdom"
"Ex_V_sign_hlaalu_01"	"Hlaalu Canton"
"Ex_V_sign_redoran_01"	"Redoran Canton"
"Ex_V_sign_stdeyln_01"	"Saint Deyln Canton"
"Ex_V_sign_stolms_01"	"Saint Olms Canton"
"Ex_V_sign_telvanni_01"	"Telvanni Canton"
"Ex_vivec_roadmarker_01"	"Vivec"
"furn_banner_councilclub"	"Council Club"
"furn_banner_dagoth_01"	"House Dagoth"
"furn_banner_hlaalu_01"	"House Hlaalu"
"furn_banner_hlaalu_vivec"	"House Hlaalu"
"furn_banner_tavern_01"	"Dunmer Tavern"
"furn_banner_tavern_a4_01"	"Sethans Tradehouse"
"furn_banner_tavern_aldruhncounc"	"Ald-ruhn Council Club"
"furn_banner_tavern_aldruhnskar"	"Ald Skar Inn"
"furn_banner_tavern_d4_01"	"The Covenant"
"furn_banner_tavern_eightplates"	"Eight Plates"
"furn_banner_tavern_elven"	"Elven Nations CornerClub"
"furn_banner_tavern_gnisis"	"Madach Tradehouse"
"furn_banner_tavern_luckylock"	"Lucky Lockup"
"furn_banner_tavern_maar gaan"	"Andus Tradehouse"
"furn_banner_tavern_noname"	"No Name Club"
"furn_banner_tavern_sadrithmora"	"Fara's Hole in the Wall"
"furn_banner_tavern_southwall"	"South Wall Cornerclub"
"furn_banner_tavern_suran_01"	"Suran Tradehouse"
"furn_banner_tavern_suran_02"	"House of Earthly Delights"
"furn_banner_tavern_telaruhn"	"Pot and Plaster"
"furn_banner_tavern_V_BSC"	"Black Shalk Cornerclub"
"furn_banner_tavern_V_ENC"	"Elven Nations Cornerclub"
"furn_banner_tavern_V_TFOG"	"The Flowes of Gold"
"furn_banner_tavern_V_TLH"	"The Lizard's Head"
"furn_banner_temple_01"	"Dunmer Temple"
"furn_banner_temple_02"	"Dunmer Temple"
"furn_banner_temple_02_interior"	"Dunmer Temple"
"furn_banner_temple_03"	"Dunmer Temple"
"furn_banner_temple_Delyn"	"The Abbey of St. Delyn the Wise"
"furn_banner_temple_Delyn_01"	"The Abbey of St. Delyn the Wise"
"furn_banner_temple_stolms"	"Temple of St. Olms"
"furn_banner_temple_V_T"	"Telvanni Temple"
"furn_bannerd_alchemy_01"	"Dunmer Alchemy"
"furn_bannerd_alchemy_01_ald_in"	"Cienne Sintieve: Alchemist"
"furn_bannerd_alchemy_01_bal"	"Nalcarya: Alchemist"
"furn_bannerd_alchemy_d4_01"	"Jolda: Apothecary"
"furn_bannerd_alchemy_hlaalu"	"Hlaalu Alchemist"
"furn_bannerd_alchemy_sadrithmor"	"Anis Seloth: Alchemist"
"furn_bannerd_alchemy_suran"	"Ibarnadad Assirnarari: Apotheca"
"furn_bannerd_alchemy_telaruhn"	"Bildren Areleth: Apothecary"
"furn_bannerd_alchemy_V_AD"	"Andilu Drothan: Alchemist"
"furn_bannerd_alchemy_V_AF"	"Aurane Frernis: Apothecary"
"furn_bannerd_alchemy_V_EA"	"Edryno Arethi: Alchemist"
"furn_bannerd_alchemy_V_J"	"J'Rasha: Healer"
"furn_bannerd_alchemy_V_MG"	"Miun-Gei: Enchanter"
"furn_bannerd_alchemy_V_RO"	"Rolasa Oren: Alchemist"
"furn_bannerd_alchemy_V_TA"	"Telvanni Apothecary"
"furn_bannerd_alchemy_V_TAL"	"Telvanni Alchemist"
"furn_bannerd_alchemy_V_TM"	"Telvanni Mage"
"furn_bannerd_alchemy_V_TS"	"Telvanni Sorcerer"
"furn_bannerd_books_aldruhnbook"	"Codus Callonus: Bookseller"
"furn_bannerd_books_balmorabook"	"Dorisa Darvel: Bookseller"
"furn_bannerd_books_V_JRB"	"Jobasha's Rare Books"
"furn_bannerd_books_V_SF"	"Simine Fralinie: Bookseller"
"furn_bannerd_clothing_01"	"Dunmer Clothing"
"furn_bannerd_clothing_01_ald_in"	"Bivale Teneran: Clothier"
"furn_bannerd_clothing_01_hastie"	"Milie Hastien: Fine Clothier"
"furn_bannerd_clothing_d4_01"	"Elegnan: Clothier"
"furn_bannerd_clothing_ravirr"	"Ra'Virr: Trader"
"furn_bannerd_clothing_suran"	"Verara Rendo: Clothier"
"furn_bannerd_clothing_V_AH"	"Agrippina Herennia: Clothier"
"furn_bannerd_clothing_V_TDH"	"Tailors and Dyers Hall"
"furn_bannerd_danger_01"	"Danger"
"furn_bannerd_ench_vari"	"Vari: Enchanter"
"furn_bannerd_goods_01"	"Dunmer Trader"
"furn_bannerd_goods_a4_01"	"Fadase Selvayn: Trader"
"furn_bannerd_goods_aldruhnbook"	"Codus Callonus: Bookseller"
"furn_bannerd_goods_aldruhnpawn"	"Daynes Redothril: Pawnbroker"
"furn_bannerd_goods_aldruhntrade"	"Tiras Sadus: General Merch."
"furn_bannerd_goods_balmorabook"	"Dorisa Darvel: Bookseller"
"furn_bannerd_goods_balmoraoutf"	"Clagius Clanler: Outfitter"
"furn_bannerd_goods_balmorapawn"	"Dralasa Nithryon: Pawnbroker"
"furn_bannerd_goods_braven"	"Tervur Braven: Trader"
"furn_bannerd_goods_d4_01"	"Berwen: Trader"
"furn_bannerd_goods_fererus"	"Mevel Fererus: Trader"
"furn_bannerd_goods_glass"	"Glassworker's Hall"
"furn_bannerd_goods_hlaalu"	"Hlaalu General Goods"
"furn_bannerd_goods_potter"	"Potter's Hall"
"furn_bannerd_goods_suran_01"	"Ralds Oril: Trader"
"furn_bannerd_goods_suran_02"	"Ranosa Gilvayn: Outfitter"
"furn_bannerd_goods_telaruhn"	"Ferele Athram: Trader"
"furn_bannerd_goods_V_BFM"	"Brewers and Fishmongers Hall"
"furn_bannerd_goods_V_FLH"	"Farmers and Laborers Hall"
"furn_bannerd_goods_V_JRB"	"Jobasha's Rare Books"
"furn_bannerd_goods_V_SF"	"Simine Fralinie: Bookseller"
"furn_bannerd_goods_V_TE"	"Telvanni Enchanter"
"furn_bannerd_goods_V_TMH"	"Tanners and Miners Hall"
"furn_bannerd_trader_ravirr"	"Ra'Virr: Trader"
"furn_bannerd_trader_V_B"	"Baissa: Trader"
"furn_bannerd_trader_V_BA"	"Balen Andrano: Trader"
"furn_bannerd_trader_V_J"	"Jeanne: Trader"
"furn_bannerd_wa_shop_01"	"Dunmer Weapons/Armor"
"furn_bannerd_wa_shop_a4_01"	"Galen Berer: Armorer"
"furn_bannerd_wa_shop_aldruhn"	"Dandera Selaro: Smith"
"furn_bannerd_wa_shop_balmoraraz"	"The Razor Hole"
"furn_bannerd_wa_shop_d4_01"	"Radras: Smith"
"furn_bannerd_wa_shop_d4_02"	"Smith"
"furn_bannerd_wa_shop_hlaalu"	"Hlaalu Weaponsmith"
"furn_bannerd_wa_shop_meldor"	"Meldor: Armorer"
"furn_bannerd_wa_shop_suran"	"Garothmuk gro-Muzgub: Smith"
"furn_bannerd_wa_shop_suran_01"	"Garothmuk gro-Muzgub: Smith"
"furn_bannerd_wa_shop_telaruhn"	"Aryne Telnim: Smith"
"furn_bannerd_wa_shop_V_AFT"	"Arena Fighter's Training"
"furn_bannerd_wa_shop_V_S"	"Savard: Smith"
"furn_bannerd_welcome_01"	"Welcome"
"furn_de_banner_book_01"	
"furn_de_banner_pawn_01"	
"furn_de_banner_pawn_Hlaalu"	"Hlaalu Pawnbroker"
"furn_de_banner_pawn_suran"	"Goldyn Belaram: Pawnbroker"
"furn_de_banner_telvani_01"	
"furn_de_in_banner_telvani_01"	
"furn_imp_flag_01"	
"furn_redoran_flag_01"	"House Redoran"
"furn_redoran_flag_01_out"	"House Redoran"
"furn_sign_arms_01"	"Imperial Arms"
"furn_sign_arms_uulernil"	"Uulernil's Arms"
"furn_sign_inn_01"	"Imperial Tavern"
"furn_sign_inn_arrille"	"Arrille's Tradehouse"
"furn_sign_inn_endofworld"	"The End of the World"
"furn_sign_inn_halfway"	"Halfway Tavern"
"furn_sign_inn_muriel"	"Dirty Muriel's Cornerclub"
"tavern sign"	"Imperial Tavern"
