# [Filetype: Wrye Mash Remover]
# *Some* of the monsters and other enemies added by the Giants mod.
# This is from a personally edited version of the mod and so does 
# not include *all* of the foes from Giants 
# by Dragon32

# GIANTS Ultimate 2.7.1
"ancestor_ghost_GLOW In"	"Ancestor Ghost"
"ancestor_ghost_greater2"	"Greater Ancestor Ghost"
"ancestor_ghost_greater3"	"Greater Ancestor Ghost"
"ancestor_ghost_luminous"	"Luminous Ghost"
"ancestor_ghost_Sleep"	"Ancestor Ghost"
"Apostate_Beholder"	"Greater Abomination"
"Apparition_Ex_low"	"Apparition"
"Apparition_In_low"	"Apparition"
"atronach_frost_BM_G"	"Dire Frost Atronach"
"BM_ice_troll_Giants"	"Grahl"
"BM_riekling_Giants"	"Riekler"
"BM_udyrfrykte_Giants"	"Abomination"
"bonelord_King_"	"Bonelord"
"bonewalker_King_"	"Bonewalker"
"dg_atronach_ebony"	"Ebony Golem"
"dg_atronach_glass"	"Glass Golem"
"Dragon01"	"Dragon"
"Dragon03"	"Elder Dragon"
"dreugh_Giants"	"Dreugh Warlord"
"earth_golem1"	"Earth Golem"
"ghost_SPECTRE"	"Spectral Apparition"
"ghost_SPECTRE_lunimous"	"Spectral Apparition"
"ghost_SPECTRE_tomb"	"Spectral Apparition"
"ghost_SPECTRE_tomb2"	"Spectral Apparition"
"Giant_skeleton"	"Giant Skeleton"
"Giant_skeleton_Molag"	"Giant Skeleton"
"Giant_skeleton2"	"Giant Skeleton"
"Giant_skeleton2_Molag"	"Giant Skeleton"
"imp_ice"	"Ice Imp"
"Imp01"	"Imp"
"Imp02_Adv"	"Elder Imp"
"Killer_netch"	"Killer Netch"
"lich_Giants"	"Lich"
"Mummy01"	"Mummy"
"Mummy02"	"Mummy"
"rat_King_"	"Rat"
"rat_Lich"	"Ancient Lich"
"Rot_worm_G"	"Rot Worm"
"Rot_worm_G2"	"Rot Worm"
"Sea_devil"	"Sea Devil"
"shalk_stalker01"	"Shalk Stalker"
"shalk_stalker01b"	"Shalk Stalker"
"shalk_stalker02"	"Shalk Stalker"
"shalk_stalker02a"	"Shalk Stalker"
"skeleton archer_Giants"	"Skeleton Archer"
"skeleton warrior_Giants"	"Skeleton Warrior"
"skeleton_Giants"	"Skeleton"
"skeleton_King_"	"Skeleton"
"skeleton_King_Lich"	"Skeleton"
"skeleton_Knight_"	"Skeleton Knight"
"skeleton_Knight_Axe"	"Skeleton Knight"
"skeleton_Knight_Mace"	"Skeleton Knight"
"skeleton_Knight_Spear"	"Skeleton Knight"
"skeletonchampion_Giants"	"Skeleton Champion"
"spider_black"	"Giant Spider"
"spider_black_GIANT"	"Giant Spider"
"spider_black_small"	"Tarantula"
"spider_black_small_In"	"Tarantula"
"spider_black_small2"	"Tarantula"
"spider_black_small2_In"	"Tarantula"
"spider_brown"	"Giant Spider"
"spider_brown_GIANT"	"Giant Spider"
"spider_brown_small"	"Tarantula"
"spider_brown_small_In"	"Tarantula"
"spider_brown_small2"	"Tarantula"
"spider_brown_small2_In"	"Tarantula"
"spider_Dwemer"	"Dwemer Mech-Spider"
"spider_Dwemer01"	"Dwemer Mech-Spider"
"Spiker_Dwemer"	"Dwemer Spiker"
"Spriggan01"	"Earth Spriggan"
"Wasp_Dwemer"	"Dwemer Mech-Wasp"
"Wraith_1 high A"	"Wraith"
"Wraith_1 high"	"Wraith"
"Wraith_1"	"Wraith"
"Wraith_1_LA"	"Wraith"
"Wraith_2 high"	"Wraith"
"Wraith_2 high_In"	"Wraith"
"Wraith_2"	"Wraith"
"Wraith_2_In"	"Wraith"
"Wraith_3 high"	"Wraith"
"Wraith_3"	"Wraith"
"Wraith_3_high In"	"Wraith"
"Wraith_3_In"	"Wraith"
"Zombie01"	"Zombie"
"Zombie01_Res1"	"Zombie"
"Zombie01_Res2"	"Zombie"
"Zombie01_Res3"	"Zombie"
"Zombie01A"	"Zombie"
"Zombie02"	"Zombie"
"Zombie02_Res1"	"Zombie"
"Zombie02_Res2"	"Zombie"
"Zombie02_Res3"	"Zombie"
"Zombie02A"	"Zombie"
"Zombie03"	"Zombie"
"Zombie03_Res1"	"Zombie"
"Zombie03_Res2"	"Zombie"
"Zombie03_Res3"	"Zombie"
"Zombie03A"	"Zombie"
"Zombie04"	"Zombie"
"BM_reaver_kingpin"	"Reaver Kingpin"
"BM_reaver_kingpin_2"	"Reaver Kingpin"
"GI_black_shade"	"Black Shadow"
"GI_phantom_archer"	"Phantom Archer"
"GI_phantom_mage"	"Phantom Mage"
"GI_phantom_warrior"	"Phantom Warrior"
"Litch_ancient01"	"Ancient Lich"
"Litch_ancient02"	"Ancient Lich"
"Litch_ancient03"	"Ancient Lich"
"Litch_ancient04"	"Ancient Lich"
"Litch1"	"Skeleton Gladiator"
"Litch2"	"Skeleton Gladiator"
"Litch3"	"Skeleton Gladiator"
"Litch4"	"Skeleton Gladiator"
"Mummy_ascended1"	"Ascended Mummy"
"Mummy_ascended1a"	"Ascended Mummy"
"Mummy_ascended2"	"Ascended Mummy"
"Mummy_ascended3"	"Ascended Mummy"
"Mummy_ascended4"	"Ascended Mummy"
"Mummy_ascended5"	"Ascended Mummy"
"Mummy_ascended6"	"Ascended Mummy"
"Mummy_ascended7"	"Ascended Mummy"
"Phantasm1"	"Phantasm Archer"
"Phantasm2"	"Phantasm"
"Phantasm3"	"Phantasm"
"Phantasm4"	"Phantasm"
"Shade15"	"Lesser Shade"
"Shade18"	"Shade Archer"
"Shade21"	"Shade Warrior"
"Shade24"	"Shade Mage"
"Shade27"	"Shade Hunter"
"Shade30"	"Devil Shade"
"Shade33"	"Greater Shade"
"Shade42"	"Shade Lord"