# [Filetype: Wrye Mash Remover]
# Neoptolemus' MCA 4.1 NPCs.

# MCA 4.1
"_MCA_apothecary_alt_f"	"Apothecary"
"_MCA_apothecary_alt_m"	"Apothecary"
"_MCA_apothecary_bos_f"	"Apothecary"
"_MCA_apothecary_bos_m"	"Apothecary"
"_MCA_apothecary_bret_f"	"Apothecary"
"_MCA_apothecary_bret_m"	"Apothecary"
"_MCA_apothecary_dun_f"	"Apothecary"
"_MCA_apothecary_dun_m"	"Apothecary"
"_MCA_apothecary_imp_f"	"Apothecary"
"_MCA_apothecary_imp_m"	"Apothecary"
"_MCA_archer_altmer_f"	"Archer"
"_MCA_archer_altmer_m"	"Archer"
"_MCA_archer_argonian_f"	"Archer"
"_MCA_archer_argonian_m"	"Archer"
"_MCA_archer_bosmer_f"	"Archer"
"_MCA_archer_bosmer_m"	"Archer"
"_MCA_archer_breton_f"	"Archer"
"_MCA_archer_breton_m"	"Archer"
"_MCA_archer_dunmer_f"	"Archer"
"_MCA_archer_dunmer_m"	"Archer"
"_MCA_archer_imperial_f"	"Archer"
"_MCA_archer_imperial_m"	"Archer"
"_MCA_archer_khajiit_f"	"Archer"
"_MCA_archer_khajiit_m"	"Archer"
"_MCA_archer_nord_f"	"Archer"
"_MCA_archer_nord_m"	"Archer"
"_MCA_archer_orc_f"	"Archer"
"_MCA_archer_orc_m"	"Archer"
"_MCA_archer_redguard_f"	"Archer"
"_MCA_archer_redguard_m"	"Archer"
"_MCA_ashlander_a_f1"	"Ahemmusa Ashlander"
"_MCA_ashlander_a_f2"	"Ahemmusa Ashlander"
"_MCA_ashlander_a_f3"	"Ahemmusa Ashlander"
"_MCA_ashlander_a_m1"	"Ahemmusa Ashlander"
"_MCA_ashlander_a_m2"	"Ahemmusa Ashlander"
"_MCA_ashlander_a_m3"	"Ahemmusa Ashlander"
"_MCA_ashlander_e_f1"	"Erabenimsun Ashlander"
"_MCA_ashlander_e_f2"	"Erabenimsun Ashlander"
"_MCA_ashlander_e_f3"	"Erabenimsun Ashlander"
"_MCA_ashlander_e_m1"	"Erabenimsun Ashlander"
"_MCA_ashlander_e_m2"	"Erabenimsun Ashlander"
"_MCA_ashlander_e_m3"	"Erabenimsun Ashlander"
"_MCA_ashlander_f1"	"Ashlander"
"_MCA_ashlander_f2"	"Ashlander"
"_MCA_ashlander_f3"	"Ashlander"
"_MCA_ashlander_m1"	"Ashlander"
"_MCA_ashlander_m2"	"Ashlander"
"_MCA_ashlander_m3"	"Ashlander"
"_MCA_ashlander_u_f1"	"Urshilaku Ashlander"
"_MCA_ashlander_u_f2"	"Urshilaku Ashlander"
"_MCA_ashlander_u_f3"	"Urshilaku Ashlander"
"_MCA_ashlander_u_m1"	"Urshilaku Ashlander"
"_MCA_ashlander_u_m2"	"Urshilaku Ashlander"
"_MCA_ashlander_u_m3"	"Urshilaku Ashlander"
"_MCA_ashlander_z_f1"	"Zainab Ashlander"
"_MCA_ashlander_z_f2"	"Zainab Ashlander"
"_MCA_ashlander_z_f3"	"Zainab Ashlander"
"_MCA_ashlander_z_m1"	"Zainab Ashlander"
"_MCA_ashlander_z_m2"	"Zainab Ashlander"
"_MCA_ashlander_z_m3"	"Zainab Ashlander"
"_MCA_auxiliary_a_nord_f"	"Auxiliary Archer"
"_MCA_auxiliary_a_nord_m"	"Auxiliary Archer"
"_MCA_auxiliary_a_orc_f"	"Auxiliary Archer"
"_MCA_auxiliary_a_orc_m"	"Auxiliary Archer"
"_MCA_auxiliary_bret_f1"	"Auxiliary Legionary"
"_MCA_auxiliary_bret_f2"	"Auxiliary Legionary"
"_MCA_auxiliary_bret_f3"	"Auxiliary Legionary"
"_MCA_auxiliary_bret_f4"	"Auxiliary Legionary"
"_MCA_auxiliary_bret_m1"	"Auxiliary Legionary"
"_MCA_auxiliary_bret_m2"	"Auxiliary Legionary"
"_MCA_auxiliary_bret_m3"	"Auxiliary Legionary"
"_MCA_auxiliary_dunm_f1"	"Auxiliary Legionary"
"_MCA_auxiliary_dunm_f2"	"Auxiliary Legionary"
"_MCA_auxiliary_dunm_f3"	"Auxiliary Legionary"
"_MCA_auxiliary_dunm_m1"	"Auxiliary Legionary"
"_MCA_auxiliary_dunm_m2"	"Auxiliary Legionary"
"_MCA_auxiliary_dunm_m3"	"Auxiliary Legionary"
"_MCA_auxiliary_dunm_m4"	"Auxiliary Legionary"
"_MCA_auxiliary_nord_f1"	"Auxiliary Legionary"
"_MCA_auxiliary_nord_f2"	"Auxiliary Legionary"
"_MCA_auxiliary_nord_f3"	"Auxiliary Legionary"
"_MCA_auxiliary_nord_m1"	"Auxiliary Legionary"
"_MCA_auxiliary_nord_m2"	"Auxiliary Legionary"
"_MCA_auxiliary_nord_m3"	"Auxiliary Legionary"
"_MCA_auxiliary_nord_m4"	"Auxiliary Centurion"
"_MCA_auxiliary_orc_f1"	"Auxiliary Legionary"
"_MCA_auxiliary_orc_f2"	"Auxiliary Legionary"
"_MCA_auxiliary_orc_f3"	"Auxiliary Legionary"
"_MCA_auxiliary_orc_m1"	"Auxiliary Legionary"
"_MCA_auxiliary_orc_m2"	"Auxiliary Legionary"
"_MCA_auxiliary_orc_m3"	"Auxiliary Legionary"
"_MCA_auxiliary_orc_m4"	"Auxiliary Legionary"
"_MCA_auxiliary_redg_f1"	"Auxiliary Legionary"
"_MCA_auxiliary_redg_f2"	"Auxiliary Legionary"
"_MCA_auxiliary_redg_m1"	"Auxiliary Legionary"
"_MCA_auxiliary_redg_m2"	"Auxiliary Legionary"
"_MCA_auxiliary_redg_m3"	"Auxiliary Legionary"
"_MCA_barbarian_breton"	"Barbarian"
"_MCA_barbarian_imperial"	"Barbarian"
"_MCA_barbarian_nord"	"Barbarian"
"_MCA_barbarian_orc"	"Barbarian"
"_MCA_beggar_1"	"Beggar"
"_MCA_beggar_2"	"Beggar"
"_MCA_beggar_3"	"Beggar"
"_MCA_beggar_4"	"Beggar"
"_MCA_beggar_5"	"Beggar"
"_MCA_BM_barbarian_m1"	"Barbarian"
"_MCA_BM_barbarian_m2"	"Barbarian"
"_MCA_BM_barbarian_m3"	"Barbarian"
"_MCA_BM_commoner_f1"	"Villager"
"_MCA_BM_commoner_f2"	"Villager"
"_MCA_BM_commoner_f3"	"Villager"
"_MCA_BM_commoner_f4"	"Villager"
"_MCA_BM_commoner_f5"	"Villager"
"_MCA_BM_commoner_m1"	"Villager"
"_MCA_BM_commoner_m2"	"Villager"
"_MCA_BM_commoner_m3"	"Villager"
"_MCA_BM_commoner_m4"	"Villager"
"_MCA_BM_huntsman_m1"	"Huntsman"
"_MCA_BM_huntsman_m2"	"Huntsman"
"_MCA_BM_huntsman_m3"	"Huntsman"
"_MCA_BM_huntsman_m4"	"Huntsman"
"_MCA_BM_warrior_m1"	"Warrior"
"_MCA_BM_warrior_m2"	"Warrior"
"_MCA_BM_warrior_m3"	"Warrior"
"_MCA_BM_warrior_m4"	"Warrior"
"_MCA_BM_warrior_m5"	"Warrior"
"_MCA_BM_warrior_m6"	"Warrior"
"_MCA_buoyant_armiger_cf"	"Buoyant Armiger Captain"
"_MCA_buoyant_armiger_cm"	"Buoyant Armiger Captain"
"_MCA_buoyant_armiger_f1"	"Buoyant Armiger"
"_MCA_buoyant_armiger_f2"	"Buoyant Armiger"
"_MCA_buoyant_armiger_m1"	"Buoyant Armiger"
"_MCA_buoyant_armiger_m2"	"Buoyant Armiger"
"_MCA_commoner_alt_f1"	"Commoner"
"_MCA_commoner_alt_f2"	"Commoner"
"_MCA_commoner_alt_f3"	"Commoner"
"_MCA_commoner_alt_f4"	"Commoner"
"_MCA_commoner_alt_m1"	"Commoner"
"_MCA_commoner_alt_m2"	"Commoner"
"_MCA_commoner_alt_m3"	"Commoner"
"_MCA_commoner_arg_f1"	"Commoner"
"_MCA_commoner_arg_f2"	"Commoner"
"_MCA_commoner_arg_f3"	"Commoner"
"_MCA_commoner_arg_m1"	"Commoner"
"_MCA_commoner_arg_m2"	"Commoner"
"_MCA_commoner_arg_m3"	"Commoner"
"_MCA_commoner_arg_m4"	"Commoner"
"_MCA_commoner_arg_m5"	"Commoner"
"_MCA_commoner_arg_m6"	"Commoner"
"_MCA_commoner_bos_f1"	"Commoner"
"_MCA_commoner_bos_f2"	"Commoner"
"_MCA_commoner_bos_f3"	"Commoner"
"_MCA_commoner_bos_m1"	"Commoner"
"_MCA_commoner_bos_m2"	"Commoner"
"_MCA_commoner_bos_m3"	"Commoner"
"_MCA_commoner_bret_f1"	"Commoner"
"_MCA_commoner_bret_f2"	"Commoner"
"_MCA_commoner_bret_f3"	"Commoner"
"_MCA_commoner_bret_f4"	"Commoner"
"_MCA_commoner_bret_m1"	"Commoner"
"_MCA_commoner_bret_m2"	"Commoner"
"_MCA_commoner_bret_m3"	"Commoner"
"_MCA_commoner_dun_f1"	"Commoner"
"_MCA_commoner_dun_f2"	"Commoner"
"_MCA_commoner_dun_f3"	"Commoner"
"_MCA_commoner_dun_f4"	"Commoner"
"_MCA_commoner_dun_f5"	"Commoner"
"_MCA_commoner_dun_f6"	"Commoner"
"_MCA_commoner_dun_m1"	"Commoner"
"_MCA_commoner_dun_m2"	"Commoner"
"_MCA_commoner_dun_m3"	"Commoner"
"_MCA_commoner_dun_m4"	"Commoner"
"_MCA_commoner_dun_m5"	"Commoner"
"_MCA_commoner_dun_m6"	"Commoner"
"_MCA_commoner_imp_f1"	"Commoner"
"_MCA_commoner_imp_f2"	"Commoner"
"_MCA_commoner_imp_f3"	"Commoner"
"_MCA_commoner_imp_f4"	"Commoner"
"_MCA_commoner_imp_m1"	"Commoner"
"_MCA_commoner_imp_m2"	"Commoner"
"_MCA_commoner_imp_m3"	"Commoner"
"_MCA_commoner_imp_m4"	"Commoner"
"_MCA_commoner_imp_m5"	"Commoner"
"_MCA_commoner_khaj_f1"	"Commoner"
"_MCA_commoner_khaj_f2"	"Commoner"
"_MCA_commoner_khaj_f3"	"Commoner"
"_MCA_commoner_khaj_f4"	"Commoner"
"_MCA_commoner_khaj_m1"	"Commoner"
"_MCA_commoner_khaj_m2"	"Commoner"
"_MCA_commoner_khaj_m3"	"Commoner"
"_MCA_commoner_khaj_m4"	"Commoner"
"_MCA_commoner_nord_f1"	"Commoner"
"_MCA_commoner_nord_f2"	"Commoner"
"_MCA_commoner_nord_f3"	"Commoner"
"_MCA_commoner_nord_f4"	"Commoner"
"_MCA_commoner_nord_m1"	"Commoner"
"_MCA_commoner_nord_m2"	"Commoner"
"_MCA_commoner_nord_m3"	"Commoner"
"_MCA_commoner_nord_m4"	"Commoner"
"_MCA_commoner_orc_f1"	"Commoner"
"_MCA_commoner_orc_f2"	"Commoner"
"_MCA_commoner_orc_f3"	"Commoner"
"_MCA_commoner_orc_m1"	"Commoner"
"_MCA_commoner_orc_m2"	"Commoner"
"_MCA_commoner_orc_m3"	"Commoner"
"_MCA_commoner_orc_m4"	"Commoner"
"_MCA_commoner_redg_f1"	"Commoner"
"_MCA_commoner_redg_f2"	"Commoner"
"_MCA_commoner_redg_f3"	"Commoner"
"_MCA_commoner_redg_m1"	"Commoner"
"_MCA_commoner_redg_m2"	"Commoner"
"_MCA_commoner_redg_m3"	"Commoner"
"_MCA_commoner_redg_m4"	"Commoner"
"_MCA_courtesan_altm_f1"	"Courtesan"
"_MCA_courtesan_altm_f2"	"Courtesan"
"_MCA_courtesan_altm_m1"	"Courtesan"
"_MCA_courtesan_altm_m2"	"Courtesan"
"_MCA_courtesan_bosm_f1"	"Courtesan"
"_MCA_courtesan_bosm_f2"	"Courtesan"
"_MCA_courtesan_bosm_f3"	"Courtesan"
"_MCA_courtesan_bosm_m1"	"Courtesan"
"_MCA_courtesan_bosm_m2"	"Courtesan"
"_MCA_courtesan_bosm_m3"	"Courtesan"
"_MCA_courtesan_bret_f1"	"Courtesan"
"_MCA_courtesan_bret_f2"	"Courtesan"
"_MCA_courtesan_bret_f3"	"Courtesan"
"_MCA_courtesan_bret_f4"	"Courtesan"
"_MCA_courtesan_bret_m1"	"Courtesan"
"_MCA_courtesan_bret_m2"	"Courtesan"
"_MCA_courtesan_bret_m3"	"Courtesan"
"_MCA_courtesan_dunm_f1"	"Courtesan"
"_MCA_courtesan_dunm_f2"	"Courtesan"
"_MCA_courtesan_dunm_f3"	"Courtesan"
"_MCA_courtesan_dunm_f4"	"Courtesan"
"_MCA_courtesan_dunm_f5"	"Courtesan"
"_MCA_courtesan_dunm_m1"	"Courtesan"
"_MCA_courtesan_dunm_m2"	"Courtesan"
"_MCA_courtesan_dunm_m3"	"Courtesan"
"_MCA_courtesan_imp_f1"	"Courtesan"
"_MCA_courtesan_imp_f2"	"Courtesan"
"_MCA_courtesan_imp_f3"	"Courtesan"
"_MCA_courtesan_imp_f4"	"Courtesan"
"_MCA_courtesan_imp_m1"	"Courtesan"
"_MCA_courtesan_imp_m2"	"Courtesan"
"_MCA_courtesan_imp_m3"	"Courtesan"
"_MCA_courtesan_imp_m4"	"Courtesan"
"_MCA_courtesan_nord_f1"	"Courtesan"
"_MCA_courtesan_nord_f2"	"Courtesan"
"_MCA_courtesan_nord_f3"	"Courtesan"
"_MCA_courtesan_nord_f4"	"Courtesan"
"_MCA_courtesan_nord_m1"	"Courtesan"
"_MCA_courtesan_nord_m2"	"Courtesan"
"_MCA_courtesan_nord_m3"	"Courtesan"
"_MCA_courtesan_orc_f1"	"Courtesan"
"_MCA_courtesan_redg_f1"	"Courtesan"
"_MCA_courtesan_redg_f2"	"Courtesan"
"_MCA_courtesan_redg_m1"	"Courtesan"
"_MCA_courtesan_redg_m2"	"Courtesan"
"_MCA_crusader_altmer_f"	"Crusader"
"_MCA_crusader_altmer_m"	"Crusader"
"_MCA_crusader_bosmer_f"	"Crusader"
"_MCA_crusader_bosmer_m"	"Crusader"
"_MCA_crusader_breton_f"	"Crusader"
"_MCA_crusader_breton_m"	"Crusader"
"_MCA_crusader_dunmer_f"	"Crusader"
"_MCA_crusader_dunmer_m"	"Crusader"
"_MCA_crusader_imp_f"	"Crusader"
"_MCA_crusader_imp_m"	"Crusader"
"_MCA_crusader_nord_f"	"Crusader"
"_MCA_crusader_nord_m"	"Crusader"
"_MCA_dagoth_priest_f1"	"Sixth House Priestess"
"_MCA_dagoth_priest_f2"	"Sixth House Priestess"
"_MCA_dagoth_priest_f3"	"Sixth House Priestess"
"_MCA_dagoth_priest_m1"	"Sixth House Priest"
"_MCA_dagoth_priest_m2"	"Sixth House Priest"
"_MCA_dagoth_priest_m3"	"Sixth House Priest"
"_MCA_dagoth_prophet_m1"	"Sixth House Prophet"
"_MCA_dagoth_prophet_m2"	"Sixth House Prophet"
"_MCA_dagoth_prophet_m3"	"Sixth House Prophet"
"_MCA_dagoth_soldier_f1"	"Sixth House Soldier"
"_MCA_dagoth_soldier_f2"	"Sixth House Soldier"
"_MCA_dagoth_soldier_f3"	"Sixth House Soldier"
"_MCA_dagoth_soldier_f4"	"Sixth House Soldier"
"_MCA_dagoth_soldier_f5"	"Sixth House Soldier"
"_MCA_dagoth_soldier_f6"	"Sixth House Soldier"
"_MCA_dagoth_soldier_m1"	"Sixth House Soldier"
"_MCA_dagoth_soldier_m2"	"Sixth House Soldier"
"_MCA_dagoth_soldier_m3"	"Sixth House Soldier"
"_MCA_dagoth_soldier_m4"	"Sixth House Soldier"
"_MCA_dagoth_soldier_m5"	"Sixth House Soldier"
"_MCA_dagoth_soldier_m6"	"Sixth House Soldier"
"_MCA_dreamer_f1"	"Dreamer"
"_MCA_dreamer_f2"	"Dreamer"
"_MCA_dreamer_f3"	"Dreamer"
"_MCA_dreamer_f4"	"Dreamer"
"_MCA_dreamer_f5"	"Dreamer"
"_MCA_dreamer_m1"	"Dreamer"
"_MCA_dreamer_m2"	"Dreamer"
"_MCA_dreamer_m3"	"Dreamer"
"_MCA_dreamer_m4"	"Dreamer"
"_MCA_dreamer_m5"	"Dreamer"
"_MCA_drunk_breton_1"	"Drunkard"
"_MCA_drunk_breton_2"	"Drunkard"
"_MCA_drunk_dunmer_1"	"Drunkard"
"_MCA_drunk_dunmer_2"	"Drunkard"
"_MCA_drunk_imperial_1"	"Drunkard"
"_MCA_drunk_imperial_2"	"Drunkard"
"_MCA_drunk_nord_1"	"Drunkard"
"_MCA_drunk_nord_2"	"Drunkard"
"_MCA_drunk_orc_1"	"Drunkard"
"_MCA_drunk_orc_2"	"Drunkard"
"_MCA_drunk_redguard_1"	"Drunkard"
"_MCA_drunk_redguard_2"	"Drunkard"
"_MCA_farmer_1"	"Farmer"
"_MCA_farmer_2"	"Farmer"
"_MCA_farmer_3"	"Farmer"
"_MCA_fence_bosmer"	"Fence"
"_MCA_fence_breton"	"Fence"
"_MCA_fence_dunmer"	"Fence"
"_MCA_fence_imperial"	"Fence"
"_MCA_fence_khajiit"	"Fence"
"_MCA_fence_redguard"	"Fence"
"_MCA_fighter_altmer_f"	"Fighter"
"_MCA_fighter_altmer_m"	"Fighter"
"_MCA_fighter_argonian_f"	"Fighter"
"_MCA_fighter_argonian_m"	"Fighter"
"_MCA_fighter_bosmer_f"	"Fighter"
"_MCA_fighter_bosmer_m"	"Fighter"
"_MCA_fighter_breton_f"	"Fighter"
"_MCA_fighter_breton_m"	"Fighter"
"_MCA_fighter_dunmer_f"	"Fighter"
"_MCA_fighter_dunmer_m"	"Fighter"
"_MCA_fighter_imperial_f"	"Fighter"
"_MCA_fighter_imperial_m"	"Fighter"
"_MCA_fighter_khajiit_f"	"Fighter"
"_MCA_fighter_khajiit_m"	"Fighter"
"_MCA_fighter_nord_f"	"Fighter"
"_MCA_fighter_nord_m"	"Fighter"
"_MCA_fighter_orc_f"	"Fighter"
"_MCA_fighter_orc_m"	"Fighter"
"_MCA_fighter_redguard_f"	"Fighter"
"_MCA_fighter_redguard_m"	"Fighter"
"_MCA_guard_helseth_capt"	"Royal Guard Captain"
"_MCA_guard_helseth_f1"	"Royal Guard"
"_MCA_guard_helseth_f2"	"Royal Guard"
"_MCA_guard_helseth_m1"	"Royal Guard"
"_MCA_guard_hlaalu_capt"	"Hlaalu Guard Captain"
"_MCA_guard_hlaalu_f1"	"Hlaalu Guard"
"_MCA_guard_hlaalu_f2"	"Hlaalu Guard"
"_MCA_guard_hlaalu_m1"	"Hlaalu Guard"
"_MCA_guard_hlaalu_m2"	"Hlaalu Guard"
"_MCA_guard_redoran_capt"	"Redoran Guard Captain"
"_MCA_guard_redoran_f1"	"Redoran Guard"
"_MCA_guard_redoran_f2"	"Redoran Guard"
"_MCA_guard_redoran_m1"	"Redoran Guard"
"_MCA_guard_redoran_m2"	"Redoran Guard"
"_MCA_guard_telvanni_cap"	"Telvanni Guard Captain"
"_MCA_guard_telvanni_f1"	"Telvanni Guard"
"_MCA_guard_telvanni_f2"	"Telvanni Guard"
"_MCA_guard_telvanni_m1"	"Telvanni Guard"
"_MCA_guard_telvanni_m2"	"Telvanni Guard"
"_MCA_hireling_altmer_f"	"Hireling"
"_MCA_hireling_altmer_m"	"Hireling"
"_MCA_hireling_argo_f"	"Hireling"
"_MCA_hireling_argo_m"	"Hireling"
"_MCA_hireling_bosmer_f"	"Hireling"
"_MCA_hireling_bosmer_m"	"Hireling"
"_MCA_hireling_breton_f"	"Hireling"
"_MCA_hireling_breton_m"	"Hireling"
"_MCA_hireling_dunmer_f"	"Hireling"
"_MCA_hireling_dunmer_m"	"Hireling"
"_MCA_hireling_imp_f"	"Hireling"
"_MCA_hireling_imp_m"	"Hireling"
"_MCA_hireling_khaj_f"	"Hireling"
"_MCA_hireling_khaj_m"	"Hireling"
"_MCA_hireling_nord_f"	"Hireling"
"_MCA_hireling_nord_m"	"Hireling"
"_MCA_hireling_orc_f"	"Hireling"
"_MCA_hireling_orc_m"	"Hireling"
"_MCA_hireling_redg_f"	"Hireling"
"_MCA_hireling_redg_m"	"Hireling"
"_MCA_imperial_archer_f1"	"Imperial Archer"
"_MCA_imperial_archer_f2"	"Imperial Archer"
"_MCA_imperial_archer_f3"	"Imperial Archer"
"_MCA_imperial_archer_f4"	"Imperial Archer"
"_MCA_imperial_archer_m1"	"Imperial Archer"
"_MCA_imperial_archer_m2"	"Imperial Archer"
"_MCA_imperial_archer_m3"	"Imperial Archer"
"_MCA_imperial_archer_m4"	"Imperial Archer"
"_MCA_imperial_archer_m5"	"Imperial Archer"
"_MCA_imperial_btlmage"	"Imperial Battlemage"
"_MCA_imperial_captain"	"Imperial Centurion"
"_MCA_imperial_dragon_kn"	"Imperial Dragon Knight"
"_MCA_imperial_dukes_f1"	"Duke's Guard"
"_MCA_imperial_dukes_f2"	"Duke's Guard"
"_MCA_imperial_dukes_f3"	"Duke's Guard"
"_MCA_imperial_dukes_f4"	"Duke's Guard"
"_MCA_imperial_dukes_m1"	"Duke's Guard"
"_MCA_imperial_dukes_m2"	"Duke's Guard"
"_MCA_imperial_dukes_m3"	"Duke's Guard"
"_MCA_imperial_dukes_m4"	"Duke's Guard"
"_MCA_imperial_dukes_m5"	"Duke's Guard"
"_MCA_imperial_guard_f1"	"Imperial Legionary"
"_MCA_imperial_guard_f2"	"Imperial Legionary"
"_MCA_imperial_guard_f3"	"Imperial Legionary"
"_MCA_imperial_guard_f4"	"Imperial Legionary"
"_MCA_imperial_guard_m1"	"Imperial Legionary"
"_MCA_imperial_guard_m2"	"Imperial Legionary"
"_MCA_imperial_guard_m3"	"Imperial Legionary"
"_MCA_imperial_guard_m4"	"Imperial Legionary"
"_MCA_imperial_guard_m5"	"Imperial Legionary"
"_MCA_imperial_knight_f1"	"Imperial Knight"
"_MCA_imperial_knight_f2"	"Imperial Knight"
"_MCA_imperial_knight_f3"	"Imperial Knight"
"_MCA_imperial_knight_f4"	"Imperial Knight"
"_MCA_imperial_knight_m1"	"Imperial Knight"
"_MCA_imperial_knight_m2"	"Imperial Knight"
"_MCA_imperial_knight_m3"	"Imperial Knight"
"_MCA_imperial_knight_m4"	"Imperial Knight"
"_MCA_imperial_marks_f1"	"Imperial Archer"
"_MCA_imperial_marks_f2"	"Imperial Archer"
"_MCA_imperial_marks_f3"	"Imperial Archer"
"_MCA_imperial_marks_f4"	"Imperial Archer"
"_MCA_imperial_marks_m1"	"Imperial Archer"
"_MCA_imperial_marks_m2"	"Imperial Archer"
"_MCA_imperial_marks_m3"	"Imperial Archer"
"_MCA_imperial_marks_m4"	"Imperial Archer"
"_MCA_imperial_marks_m5"	"Imperial Archer"
"_MCA_imperial_spearman1"	"Imperial Spearman"
"_MCA_imperial_spearman2"	"Imperial Spearman"
"_MCA_imperial_spearman3"	"Imperial Spearman"
"_MCA_imperial_spearman4"	"Imperial Spearman"
"_MCA_imperial_spearman5"	"Imperial Spearman"
"_MCA_knight_altmer_f"	"Knight"
"_MCA_knight_altmer_m"	"Knight"
"_MCA_knight_breton_f"	"Knight"
"_MCA_knight_breton_m"	"Knight"
"_MCA_knight_dunmer_f"	"Knight"
"_MCA_knight_dunmer_m"	"Knight"
"_MCA_knight_imperial_f"	"Knight"
"_MCA_knight_imperial_m"	"Knight"
"_MCA_knight_nord_f"	"Knight"
"_MCA_knight_nord_m"	"Knight"
"_MCA_mage_altmer_f"	"Mage"
"_MCA_mage_altmer_m"	"Mage"
"_MCA_mage_argonian_f"	"Mage"
"_MCA_mage_argonian_m"	"Mage"
"_MCA_mage_bosmer_f"	"Mage"
"_MCA_mage_bosmer_m"	"Mage"
"_MCA_mage_breton_f"	"Mage"
"_MCA_mage_breton_m"	"Mage"
"_MCA_mage_dunmer_f"	"Mage"
"_MCA_mage_dunmer_m"	"Mage"
"_MCA_mage_imperial_f"	"Mage"
"_MCA_mage_imperial_m"	"Mage"
"_MCA_mage_khajiit_f"	"Mage"
"_MCA_mage_khajiit_m"	"Mage"
"_MCA_mage_redguard_f"	"Mage"
"_MCA_mage_redguard_m"	"Mage"
"_MCA_mercenary_altm_f"	"Mercenary"
"_MCA_mercenary_altm_m"	"Mercenary"
"_MCA_mercenary_argo_f"	"Mercenary"
"_MCA_mercenary_argo_m"	"Mercenary"
"_MCA_mercenary_bosm_f"	"Mercenary"
"_MCA_mercenary_bosm_m"	"Mercenary"
"_MCA_mercenary_bret_f"	"Mercenary"
"_MCA_mercenary_bret_m"	"Mercenary"
"_MCA_mercenary_dunm_f"	"Mercenary"
"_MCA_mercenary_dunm_m"	"Mercenary"
"_MCA_mercenary_imp_f"	"Mercenary"
"_MCA_mercenary_imp_m"	"Mercenary"
"_MCA_mercenary_khaj_f"	"Mercenary"
"_MCA_mercenary_khaj_m"	"Mercenary"
"_MCA_mercenary_nord_f"	"Mercenary"
"_MCA_mercenary_nord_m"	"Mercenary"
"_MCA_mercenary_orc_f"	"Mercenary"
"_MCA_mercenary_orc_m"	"Mercenary"
"_MCA_mercenary_redg_f"	"Mercenary"
"_MCA_mercenary_redg_m"	"Mercenary"
"_MCA_merchant_breton"	"Merchant"
"_MCA_merchant_dunmer1"	"Merchant"
"_MCA_merchant_dunmer2"	"Merchant"
"_MCA_merchant_dunmer3"	"Merchant"
"_MCA_merchant_imperial"	"Merchant"
"_MCA_merchant_nord"	"Merchant"
"_MCA_merchant_redguard"	"Merchant"
"_MCA_morag_tong_f"	"Morag Tong Assassin"
"_MCA_morag_tong_m"	"Morag Tong Assassin"
"_MCA_noble_dunmer_f_h1"	"Hlaalu Noblewoman"
"_MCA_noble_dunmer_f_h2"	"Hlaalu Noblewoman"
"_MCA_noble_dunmer_f_h3"	"Hlaalu Noblewoman"
"_MCA_noble_dunmer_f_h4"	"Hlaalu Noblewoman"
"_MCA_noble_dunmer_f_h5"	"Hlaalu Noblewoman"
"_MCA_noble_dunmer_f_h6"	"Hlaalu Noblewoman"
"_MCA_noble_dunmer_f_r1"	"Redoran Noblewoman"
"_MCA_noble_dunmer_f_r2"	"Redoran Noblewoman"
"_MCA_noble_dunmer_f_r3"	"Redoran Noblewoman"
"_MCA_noble_dunmer_f_r4"	"Redoran Noblewoman"
"_MCA_noble_dunmer_f_r5"	"Redoran Noblewoman"
"_MCA_noble_dunmer_f_r6"	"Redoran Noblewoman"
"_MCA_noble_dunmer_f_t1"	"Telvanni Noblewoman"
"_MCA_noble_dunmer_f_t2"	"Telvanni Noblewoman"
"_MCA_noble_dunmer_f_t3"	"Telvanni Noblewoman"
"_MCA_noble_dunmer_f_t4"	"Telvanni Noblewoman"
"_MCA_noble_dunmer_f_t5"	"Telvanni Noblewoman"
"_MCA_noble_dunmer_f_t6"	"Telvanni Noblewoman"
"_MCA_noble_dunmer_f1"	"Noblewoman"
"_MCA_noble_dunmer_f2"	"Noblewoman"
"_MCA_noble_dunmer_f3"	"Noblewoman"
"_MCA_noble_dunmer_f4"	"Noblewoman"
"_MCA_noble_dunmer_f5"	"Noblewoman"
"_MCA_noble_dunmer_m_h1"	"Hlaalu Nobleman"
"_MCA_noble_dunmer_m_h2"	"Hlaalu Nobleman"
"_MCA_noble_dunmer_m_h3"	"Hlaalu Nobleman"
"_MCA_noble_dunmer_m_h4"	"Hlaalu Nobleman"
"_MCA_noble_dunmer_m_h5"	"Hlaalu Nobleman"
"_MCA_noble_dunmer_m_h6"	"Hlaalu Nobleman"
"_MCA_noble_dunmer_m_r1"	"Redoran Nobleman"
"_MCA_noble_dunmer_m_r2"	"Redoran Nobleman"
"_MCA_noble_dunmer_m_r3"	"Redoran Nobleman"
"_MCA_noble_dunmer_m_r4"	"Redoran Nobleman"
"_MCA_noble_dunmer_m_r5"	"Redoran Nobleman"
"_MCA_noble_dunmer_m_r6"	"Redoran Nobleman"
"_MCA_noble_dunmer_m_t1"	"Telvanni Nobleman"
"_MCA_noble_dunmer_m_t2"	"Telvanni Nobleman"
"_MCA_noble_dunmer_m_t3"	"Telvanni Nobleman"
"_MCA_noble_dunmer_m_t4"	"Telvanni Nobleman"
"_MCA_noble_dunmer_m_t5"	"Telvanni Nobleman"
"_MCA_noble_dunmer_m_t6"	"Telvanni Nobleman"
"_MCA_noble_dunmer_m1"	"Nobleman"
"_MCA_noble_dunmer_m2"	"Nobleman"
"_MCA_noble_dunmer_m3"	"Nobleman"
"_MCA_noble_dunmer_m4"	"Nobleman"
"_MCA_noble_dunmer_m5"	"Nobleman"
"_MCA_noble_dunmer_m6"	"Nobleman"
"_MCA_noble_imp_f1"	"Noblewoman"
"_MCA_noble_imp_f2"	"Noblewoman"
"_MCA_noble_imp_f3"	"Noblewoman"
"_MCA_noble_imp_f4"	"Noblewoman"
"_MCA_noble_imp_f5"	"Noblewoman"
"_MCA_noble_imp_m1"	"Nobleman"
"_MCA_noble_imp_m2"	"Nobleman"
"_MCA_noble_imp_m3"	"Nobleman"
"_MCA_noble_imp_m4"	"Nobleman"
"_MCA_noble_imp_m5"	"Nobleman"
"_MCA_noble_imp_m6"	"Nobleman"
"_MCA_novice_dunmer_f"	"Novice"
"_MCA_novice_dunmer_m"	"Novice"
"_MCA_novice_imperial_f"	"Novice"
"_MCA_novice_imperial_m"	"Novice"
"_MCA_ordinator_capt"	"Ordinator Captain"
"_MCA_ordinator_elite"	"Elite Ordinator"
"_MCA_ordinator_elite_f1"	"Elite Ordinator"
"_MCA_ordinator_elite_f2"	"Elite Ordinator"
"_MCA_ordinator_elite_f3"	"Elite Ordinator"
"_MCA_ordinator_f1"	"Ordinator"
"_MCA_ordinator_f2"	"Ordinator"
"_MCA_ordinator_f3"	"Ordinator"
"_MCA_ordinator_hand"	"Hand of Almalexia"
"_MCA_ordinator_high_f1"	"High Ordinator"
"_MCA_ordinator_high_f2"	"High Ordinator"
"_MCA_ordinator_high_m1"	"High Ordinator"
"_MCA_ordinator_high_m2"	"High Ordinator"
"_MCA_ordinator_high_m3"	"High Ordinator"
"_MCA_ordinator_m1"	"Ordinator"
"_MCA_ordinator_m2"	"Ordinator"
"_MCA_ordinator_m3"	"Ordinator"
"_MCA_pilgrim_dunmer_f"	"Pilgrim"
"_MCA_pilgrim_dunmer_m"	"Pilgrim"
"_MCA_pilgrim_shrines_f1"	"Pilgrim"
"_MCA_pilgrim_shrines_f2"	"Pilgrim"
"_MCA_pilgrim_shrines_m1"	"Pilgrim"
"_MCA_pilgrim_shrines_m2"	"Pilgrim"
"_MCA_priest_breton_f"	"Healer"
"_MCA_priest_breton_m"	"Healer"
"_MCA_priest_dunmer_f"	"Priestess"
"_MCA_priest_dunmer_m"	"Priest"
"_MCA_priest_imperial_f"	"Healer"
"_MCA_priest_imperial_m"	"Healer"
"_MCA_prisoner_arg_m1"	"Prisoner"
"_MCA_prisoner_arg_m2"	"Prisoner"
"_MCA_prisoner_bret_m1"	"Prisoner"
"_MCA_prisoner_bret_m2"	"Prisoner"
"_MCA_prisoner_dunm_m1"	"Prisoner"
"_MCA_prisoner_dunm_m2"	"Prisoner"
"_MCA_prisoner_dunm_m3"	"Prisoner"
"_MCA_prisoner_imp_m1"	"Prisoner"
"_MCA_prisoner_imp_m2"	"Prisoner"
"_MCA_prisoner_khaj_m1"	"Prisoner"
"_MCA_prisoner_khaj_m2"	"Prisoner"
"_MCA_prisoner_nord_m1"	"Prisoner"
"_MCA_prisoner_nord_m2"	"Prisoner"
"_MCA_prisoner_orc_m1"	"Prisoner"
"_MCA_prisoner_orc_m2"	"Prisoner"
"_MCA_prisoner_redg_m1"	"Prisoner"
"_MCA_prisoner_redg_m2"	"Prisoner"
"_MCA_ranger_altmer"	"Ranger"
"_MCA_ranger_bosmer"	"Ranger"
"_MCA_ranger_breton"	"Ranger"
"_MCA_ranger_dunmer"	"Ranger"
"_MCA_ranger_imperial"	"Ranger"
"_MCA_ranger_nord"	"Ranger"
"_MCA_rogue_bosmer_f"	"Rogue"
"_MCA_rogue_bosmer_m"	"Rogue"
"_MCA_rogue_breton_f"	"Rogue"
"_MCA_rogue_breton_m"	"Rogue"
"_MCA_rogue_dunmer_f"	"Rogue"
"_MCA_rogue_dunmer_m"	"Rogue"
"_MCA_rogue_imperial_f"	"Rogue"
"_MCA_rogue_imperial_m"	"Rogue"
"_MCA_rogue_khajiit_f"	"Rogue"
"_MCA_rogue_khajiit_m"	"Rogue"
"_MCA_rogue_redguard_f"	"Rogue"
"_MCA_rogue_redguard_m"	"Rogue"
"_MCA_server_bosmer1"	"Serving Girl"
"_MCA_server_bosmer2"	"Serving Girl"
"_MCA_server_bosmer3"	"Serving Girl"
"_MCA_server_bosmer4"	"Serving Girl"
"_MCA_server_bosmer5"	"Serving Girl"
"_MCA_server_breton1"	"Serving Girl"
"_MCA_server_breton2"	"Serving Girl"
"_MCA_server_breton3"	"Serving Girl"
"_MCA_server_dunmer0"	"Serving Girl"
"_MCA_server_dunmer1"	"Serving Girl"
"_MCA_server_dunmer2"	"Serving Girl"
"_MCA_server_dunmer3"	"Serving Girl"
"_MCA_server_dunmer4"	"Serving Girl"
"_MCA_server_dunmer5"	"Serving Girl"
"_MCA_server_dunmer6"	"Serving Girl"
"_MCA_server_dunmer7"	"Serving Girl"
"_MCA_server_dunmer8"	"Serving Girl"
"_MCA_server_dunmer9"	"Serving Girl"
"_MCA_server_imperial1"	"Serving Girl"
"_MCA_server_imperial2"	"Serving Girl"
"_MCA_server_nord1"	"Serving Girl"
"_MCA_server_redguard1"	"Serving Girl"
"_MCA_traveller_alt_f"	"Traveler"
"_MCA_traveller_alt_m"	"Traveler"
"_MCA_traveller_argo_f"	"Traveler"
"_MCA_traveller_argo_m"	"Traveler"
"_MCA_traveller_bos_f1"	"Traveler"
"_MCA_traveller_bos_f2"	"Traveler"
"_MCA_traveller_bos_m1"	"Traveler"
"_MCA_traveller_bos_m2"	"Traveler"
"_MCA_traveller_bret_f1"	"Traveler"
"_MCA_traveller_bret_f2"	"Traveler"
"_MCA_traveller_bret_m1"	"Traveler"
"_MCA_traveller_bret_m2"	"Traveler"
"_MCA_traveller_dunm_f1"	"Traveler"
"_MCA_traveller_dunm_f2"	"Traveler"
"_MCA_traveller_dunm_m1"	"Traveler"
"_MCA_traveller_dunm_m2"	"Traveler"
"_MCA_traveller_imp_f1"	"Traveler"
"_MCA_traveller_imp_f2"	"Traveler"
"_MCA_traveller_imp_m1"	"Traveler"
"_MCA_traveller_imp_m2"	"Traveler"
"_MCA_traveller_khaj_f"	"Traveler"
"_MCA_traveller_khaj_m"	"Traveler"
"_MCA_traveller_nord_f1"	"Traveler"
"_MCA_traveller_nord_f2"	"Traveler"
"_MCA_traveller_nord_m1"	"Traveler"
"_MCA_traveller_nord_m2"	"Traveler"
"_MCA_traveller_orc_f"	"Traveler"
"_MCA_traveller_orc_m"	"Traveler"
"_MCA_traveller_redg_f"	"Traveler"
"_MCA_traveller_redg_m"	"Traveler"
"_MCA_warrior_altmer_f"	"Warrior"
"_MCA_warrior_altmer_m"	"Warrior"
"_MCA_warrior_argonian_f"	"Warrior"
"_MCA_warrior_argonian_m"	"Warrior"
"_MCA_warrior_bosmer_f"	"Warrior"
"_MCA_warrior_bosmer_m"	"Warrior"
"_MCA_warrior_breton_f"	"Warrior"
"_MCA_warrior_breton_m"	"Warrior"
"_MCA_warrior_dunmer_f"	"Warrior"
"_MCA_warrior_dunmer_m"	"Warrior"
"_MCA_warrior_imperial_f"	"Warrior"
"_MCA_warrior_imperial_m"	"Warrior"
"_MCA_warrior_khajiit_f"	"Warrior"
"_MCA_warrior_khajiit_m"	"Warrior"
"_MCA_warrior_nord_f"	"Warrior"
"_MCA_warrior_nord_m"	"Warrior"
"_MCA_warrior_orc_f"	"Warrior"
"_MCA_warrior_orc_m"	"Warrior"
"_MCA_warrior_redguard_f"	"Warrior"
"_MCA_warrior_redguard_m"	"Warrior"
"_MCAV_w_vamp_a_altm_f"	"Ancient Vampire"
"_MCAV_w_vamp_a_altm_m"	"Ancient Vampire"
"_MCAV_w_vamp_a_bret_f"	"Ancient Vampire"
"_MCAV_w_vamp_a_bret_m"	"Ancient Vampire"
"_MCAV_w_vamp_a_dunm_f"	"Ancient Vampire"
"_MCAV_w_vamp_a_dunm_m"	"Ancient Vampire"
"_MCAV_w_vamp_a_imp_f"	"Ancient Vampire"
"_MCAV_w_vamp_a_imp_m"	"Ancient Vampire"
"_MCAV_w_vamp_a_nord_f"	"Ancient Vampire"
"_MCAV_w_vamp_a_nord_m"	"Ancient Vampire"
"_MCAV_w_vamp_e_altm_f"	"Elder Vampire"
"_MCAV_w_vamp_e_altm_m"	"Elder Vampire"
"_MCAV_w_vamp_e_bosm_f"	"Elder Vampire"
"_MCAV_w_vamp_e_bosm_m"	"Elder Vampire"
"_MCAV_w_vamp_e_bret_f"	"Elder Vampire"
"_MCAV_w_vamp_e_bret_m"	"Elder Vampire"
"_MCAV_w_vamp_e_dunm_f"	"Elder Vampire"
"_MCAV_w_vamp_e_dunm_m"	"Elder Vampire"
"_MCAV_w_vamp_e_imp_f"	"Elder Vampire"
"_MCAV_w_vamp_e_imp_m"	"Elder Vampire"
"_MCAV_w_vamp_e_nord_f"	"Elder Vampire"
"_MCAV_w_vamp_e_nord_m"	"Elder Vampire"
"_MCAV_w_vamp_e_redg_f"	"Elder Vampire"
"_MCAV_w_vamp_e_redg_m"	"Elder Vampire"
"_MCAV_w_vamp_l_altm_f"	"Vampire Lady"
"_MCAV_w_vamp_l_altm_m"	"Vampire Lord"
"_MCAV_w_vamp_l_bosm_f"	"Vampire Lady"
"_MCAV_w_vamp_l_bosm_m"	"Vampire Lord"
"_MCAV_w_vamp_l_bret_f"	"Vampire Lady"
"_MCAV_w_vamp_l_bret_m"	"Vampire Lord"
"_MCAV_w_vamp_l_dunm_f"	"Vampire Lady"
"_MCAV_w_vamp_l_dunm_m"	"Vampire Lord"
"_MCAV_w_vamp_l_imp_f"	"Vampire Lady"
"_MCAV_w_vamp_l_imp_m"	"Vampire Lord"
"_MCAV_w_vamp_l_nord_f"	"Vampire Lady"
"_MCAV_w_vamp_l_nord_m"	"Vampire Lord"
"_MCAV_w_vamp_l_redg_f"	"Vampire Lady"
"_MCAV_w_vamp_l_redg_m"	"Vampire Lord"
"_MCAV_w_vamp_n_altm_f"	"Vampire"
"_MCAV_w_vamp_n_altm_m"	"Vampire"
"_MCAV_w_vamp_n_argon_f"	"Vampire"
"_MCAV_w_vamp_n_argon_m"	"Vampire"
"_MCAV_w_vamp_n_bosm_f"	"Vampire"
"_MCAV_w_vamp_n_bosm_m"	"Vampire"
"_MCAV_w_vamp_n_bret_f"	"Vampire"
"_MCAV_w_vamp_n_bret_m"	"Vampire"
"_MCAV_w_vamp_n_dunm_f"	"Vampire"
"_MCAV_w_vamp_n_dunm_m"	"Vampire"
"_MCAV_w_vamp_n_imp_f"	"Vampire"
"_MCAV_w_vamp_n_imp_m"	"Vampire"
"_MCAV_w_vamp_n_khaj_f"	"Vampire"
"_MCAV_w_vamp_n_khaj_m"	"Vampire"
"_MCAV_w_vamp_n_nord_f"	"Vampire"
"_MCAV_w_vamp_n_nord_m"	"Vampire"
"_MCAV_w_vamp_n_orc_f"	"Vampire"
"_MCAV_w_vamp_n_orc_m"	"Vampire"
"_MCAV_w_vamp_n_redg_f"	"Vampire"
"_MCAV_w_vamp_n_redg_m"	"Vampire"
"_MCAV_w_vamp_y_altm_f"	"Yearling Vampire"
"_MCAV_w_vamp_y_altm_m"	"Yearling Vampire"
"_MCAV_w_vamp_y_argon_f"	"Yearling Vampire"
"_MCAV_w_vamp_y_argon_m"	"Yearling Vampire"
"_MCAV_w_vamp_y_bosm_f"	"Yearling Vampire"
"_MCAV_w_vamp_y_bosm_m"	"Yearling Vampire"
"_MCAV_w_vamp_y_bret_f"	"Yearling Vampire"
"_MCAV_w_vamp_y_bret_m"	"Yearling Vampire"
"_MCAV_w_vamp_y_dunm_f"	"Yearling Vampire"
"_MCAV_w_vamp_y_dunm_m"	"Yearling Vampire"
"_MCAV_w_vamp_y_imp_f"	"Yearling Vampire"
"_MCAV_w_vamp_y_imp_m"	"Yearling Vampire"
"_MCAV_w_vamp_y_khaj_f"	"Yearling Vampire"
"_MCAV_w_vamp_y_khaj_m"	"Yearling Vampire"
"_MCAV_w_vamp_y_nord_f"	"Yearling Vampire"
"_MCAV_w_vamp_y_nord_m"	"Yearling Vampire"
"_MCAV_w_vamp_y_orc_f"	"Yearling Vampire"
"_MCAV_w_vamp_y_orc_m"	"Yearling Vampire"
"_MCAV_w_vamp_y_redg_f"	"Yearling Vampire"
"_MCAV_w_vamp_y_redg_m"	"Yearling Vampire"
"_MCAV_werewolf_100"	"Werewolf"
"_MCAV_werewolf_40"	"Werewolf"
"_MCAV_werewolf_60"	"Werewolf"
"_MCAV_werewolf_80"	"Werewolf"
"_MCAW_archer_altmer_f"	"Archer"
"_MCAW_archer_altmer_m"	"Archer"
"_MCAW_archer_argonian_f"	"Archer"
"_MCAW_archer_argonian_m"	"Archer"
"_MCAW_archer_bosmer_f"	"Archer"
"_MCAW_archer_bosmer_m"	"Archer"
"_MCAW_archer_breton_f"	"Archer"
"_MCAW_archer_breton_m"	"Archer"
"_MCAW_archer_dunmer_f"	"Archer"
"_MCAW_archer_dunmer_m"	"Archer"
"_MCAW_archer_imperial_f"	"Archer"
"_MCAW_archer_imperial_m"	"Archer"
"_MCAW_archer_khajiit_f"	"Archer"
"_MCAW_archer_khajiit_m"	"Archer"
"_MCAW_archer_nord_f"	"Archer"
"_MCAW_archer_nord_m"	"Archer"
"_MCAW_archer_orc_f"	"Archer"
"_MCAW_archer_orc_m"	"Archer"
"_MCAW_archer_redguard_f"	"Archer"
"_MCAW_archer_redguard_m"	"Archer"
"_MCAW_armiger_captain_f"	"Buoyant Armiger Captain"
"_MCAW_armiger_captain_m"	"Buoyant Armiger Captain"
"_MCAW_armiger_dead"	"Dead Buoyant Armiger"
"_MCAW_armiger_f1"	"Buoyant Armiger"
"_MCAW_armiger_f2"	"Buoyant Armiger"
"_MCAW_armiger_m1"	"Buoyant Armiger"
"_MCAW_armiger_m2"	"Buoyant Armiger"
"_MCAW_ashlander_a_f1"	"Ahemmusa Ashlander"
"_MCAW_ashlander_a_f2"	"Ahemmusa Ashlander"
"_MCAW_ashlander_a_f3"	"Ahemmusa Ashlander"
"_MCAW_ashlander_a_m1"	"Ahemmusa Ashlander"
"_MCAW_ashlander_a_m2"	"Ahemmusa Ashlander"
"_MCAW_ashlander_a_m3"	"Ahemmusa Ashlander"
"_MCAW_ashlander_e_f1"	"Erabenimsun Ashlander"
"_MCAW_ashlander_e_f2"	"Erabenimsun Ashlander"
"_MCAW_ashlander_e_f3"	"Erabenimsun Ashlander"
"_MCAW_ashlander_e_m1"	"Erabenimsun Ashlander"
"_MCAW_ashlander_e_m2"	"Erabenimsun Ashlander"
"_MCAW_ashlander_e_m3"	"Erabenimsun Ashlander"
"_MCAW_ashlander_f_05a"	"Outcast Ashlander"
"_MCAW_ashlander_f_05b"	"Outcast Ashlander"
"_MCAW_ashlander_f_05c"	"Outcast Ashlander"
"_MCAW_ashlander_f_05d"	"Outcast Ashlander"
"_MCAW_ashlander_f_05e"	"Outcast Ashlander"
"_MCAW_ashlander_f_05f"	"Outcast Ashlander"
"_MCAW_ashlander_f_15a"	"Outcast Ashlander"
"_MCAW_ashlander_f_15b"	"Outcast Ashlander"
"_MCAW_ashlander_f_15c"	"Outcast Ashlander"
"_MCAW_ashlander_f_15d"	"Outcast Ashlander"
"_MCAW_ashlander_f_15e"	"Outcast Ashlander"
"_MCAW_ashlander_f_15f"	"Outcast Ashlander"
"_MCAW_ashlander_f_30a"	"Outcast Ashlander"
"_MCAW_ashlander_f_30b"	"Outcast Ashlander"
"_MCAW_ashlander_f_30c"	"Outcast Ashlander"
"_MCAW_ashlander_f_30d"	"Outcast Ashlander"
"_MCAW_ashlander_f_30e"	"Outcast Ashlander"
"_MCAW_ashlander_f_30f"	"Outcast Ashlander"
"_MCAW_ashlander_m_05a"	"Outcast Ashlander"
"_MCAW_ashlander_m_05b"	"Outcast Ashlander"
"_MCAW_ashlander_m_05c"	"Outcast Ashlander"
"_MCAW_ashlander_m_05d"	"Outcast Ashlander"
"_MCAW_ashlander_m_05e"	"Outcast Ashlander"
"_MCAW_ashlander_m_05f"	"Outcast Ashlander"
"_MCAW_ashlander_m_15a"	"Outcast Ashlander"
"_MCAW_ashlander_m_15b"	"Outcast Ashlander"
"_MCAW_ashlander_m_15c"	"Outcast Ashlander"
"_MCAW_ashlander_m_15d"	"Outcast Ashlander"
"_MCAW_ashlander_m_15e"	"Outcast Ashlander"
"_MCAW_ashlander_m_15f"	"Outcast Ashlander"
"_MCAW_ashlander_m_30a"	"Outcast Ashlander"
"_MCAW_ashlander_m_30b"	"Outcast Ashlander"
"_MCAW_ashlander_m_30c"	"Outcast Ashlander"
"_MCAW_ashlander_m_30d"	"Outcast Ashlander"
"_MCAW_ashlander_m_30e"	"Outcast Ashlander"
"_MCAW_ashlander_m_30f"	"Outcast Ashlander"
"_MCAW_ashlander_u_f1"	"Urshilaku Ashlander"
"_MCAW_ashlander_u_f2"	"Urshilaku Ashlander"
"_MCAW_ashlander_u_f3"	"Urshilaku Ashlander"
"_MCAW_ashlander_u_m1"	"Urshilaku Ashlander"
"_MCAW_ashlander_u_m2"	"Urshilaku Ashlander"
"_MCAW_ashlander_u_m3"	"Urshilaku Ashlander"
"_MCAW_ashlander_z_f1"	"Zainab Ashlander"
"_MCAW_ashlander_z_f2"	"Zainab Ashlander"
"_MCAW_ashlander_z_f3"	"Zainab Ashlander"
"_MCAW_ashlander_z_m1"	"Zainab Ashlander"
"_MCAW_ashlander_z_m2"	"Zainab Ashlander"
"_MCAW_ashlander_z_m3"	"Zainab Ashlander"
"_MCAW_auxiliary_bret_f1"	"Auxiliary Legionary"
"_MCAW_auxiliary_bret_f2"	"Auxiliary Legionary"
"_MCAW_auxiliary_bret_f3"	"Auxiliary Legionary"
"_MCAW_auxiliary_bret_f4"	"Auxiliary Legionary"
"_MCAW_auxiliary_bret_m1"	"Auxiliary Legionary"
"_MCAW_auxiliary_bret_m2"	"Auxiliary Legionary"
"_MCAW_auxiliary_bret_m3"	"Auxiliary Legionary"
"_MCAW_auxiliary_dunm_f1"	"Auxiliary Legionary"
"_MCAW_auxiliary_dunm_f2"	"Auxiliary Legionary"
"_MCAW_auxiliary_dunm_f3"	"Auxiliary Legionary"
"_MCAW_auxiliary_dunm_m1"	"Auxiliary Legionary"
"_MCAW_auxiliary_dunm_m2"	"Auxiliary Legionary"
"_MCAW_auxiliary_dunm_m3"	"Auxiliary Legionary"
"_MCAW_auxiliary_dunm_m4"	"Auxiliary Legionary"
"_MCAW_auxiliary_nord_f1"	"Auxiliary Legionary"
"_MCAW_auxiliary_nord_f2"	"Auxiliary Legionary"
"_MCAW_auxiliary_nord_f3"	"Auxiliary Legionary"
"_MCAW_auxiliary_nord_m1"	"Auxiliary Legionary"
"_MCAW_auxiliary_nord_m2"	"Auxiliary Legionary"
"_MCAW_auxiliary_nord_m3"	"Auxiliary Legionary"
"_MCAW_auxiliary_orc_f1"	"Auxiliary Legionary"
"_MCAW_auxiliary_orc_f2"	"Auxiliary Legionary"
"_MCAW_auxiliary_orc_f3"	"Auxiliary Legionary"
"_MCAW_auxiliary_orc_m1"	"Auxiliary Legionary"
"_MCAW_auxiliary_orc_m2"	"Auxiliary Legionary"
"_MCAW_auxiliary_orc_m3"	"Auxiliary Legionary"
"_MCAW_auxiliary_orc_m4"	"Auxiliary Legionary"
"_MCAW_auxiliary_redg_f1"	"Auxiliary Legionary"
"_MCAW_auxiliary_redg_f2"	"Auxiliary Legionary"
"_MCAW_auxiliary_redg_m1"	"Auxiliary Legionary"
"_MCAW_auxiliary_redg_m2"	"Auxiliary Legionary"
"_MCAW_auxiliary_redg_m3"	"Auxiliary Legionary"
"_MCAW_bandit_bosmer_f"	"Bandit"
"_MCAW_bandit_bosmer_m"	"Bandit"
"_MCAW_bandit_breton_f"	"Bandit"
"_MCAW_bandit_breton_m"	"Bandit"
"_MCAW_bandit_dunmer_f"	"Bandit"
"_MCAW_bandit_dunmer_m"	"Bandit"
"_MCAW_bandit_imperial_f"	"Bandit"
"_MCAW_bandit_imperial_m"	"Bandit"
"_MCAW_bandit_khajiit_f"	"Bandit"
"_MCAW_bandit_khajiit_m"	"Bandit"
"_MCAW_bandit_nord_f"	"Bandit"
"_MCAW_bandit_nord_m"	"Bandit"
"_MCAW_bandit_orc_f"	"Bandit"
"_MCAW_bandit_orc_m"	"Bandit"
"_MCAW_bandit_redguard_f"	"Bandit"
"_MCAW_bandit_redguard_m"	"Bandit"
"_MCAW_brigand_bosmer_f"	"Brigand"
"_MCAW_brigand_bosmer_m"	"Brigand"
"_MCAW_brigand_breton_f"	"Brigand"
"_MCAW_brigand_breton_m"	"Brigand"
"_MCAW_brigand_dunmer_f"	"Brigand"
"_MCAW_brigand_dunmer_m"	"Brigand"
"_MCAW_brigand_imp_f"	"Brigand"
"_MCAW_brigand_imp_m"	"Brigand"
"_MCAW_brigand_khajiit_f"	"Brigand"
"_MCAW_brigand_khajiit_m"	"Brigand"
"_MCAW_brigand_nord_f"	"Brigand"
"_MCAW_brigand_nord_m"	"Brigand"
"_MCAW_brigand_orc_f"	"Brigand"
"_MCAW_brigand_orc_m"	"Brigand"
"_MCAW_brigand_redg_f"	"Brigand"
"_MCAW_brigand_redg_m"	"Brigand"
"_MCAW_corpse_altmer_f"	"Corpse"
"_MCAW_corpse_altmer_m"	"Corpse"
"_MCAW_corpse_argo_f"	"Corpse"
"_MCAW_corpse_argo_m"	"Corpse"
"_MCAW_corpse_bosmer_f1"	"Corpse"
"_MCAW_corpse_bosmer_f2"	"Corpse"
"_MCAW_corpse_bosmer_m1"	"Corpse"
"_MCAW_corpse_bosmer_m2"	"Corpse"
"_MCAW_corpse_breton_f1"	"Corpse"
"_MCAW_corpse_breton_f2"	"Corpse"
"_MCAW_corpse_breton_m1"	"Corpse"
"_MCAW_corpse_breton_m2"	"Corpse"
"_MCAW_corpse_dunmer_f1"	"Corpse"
"_MCAW_corpse_dunmer_f2"	"Corpse"
"_MCAW_corpse_dunmer_m1"	"Corpse"
"_MCAW_corpse_dunmer_m2"	"Corpse"
"_MCAW_corpse_imp_f1"	"Corpse"
"_MCAW_corpse_imp_f2"	"Corpse"
"_MCAW_corpse_imp_m1"	"Corpse"
"_MCAW_corpse_imp_m2"	"Corpse"
"_MCAW_corpse_khajiit_f1"	"Corpse"
"_MCAW_corpse_khajiit_f2"	"Corpse"
"_MCAW_corpse_khajiit_m1"	"Corpse"
"_MCAW_corpse_khajiit_m2"	"Corpse"
"_MCAW_corpse_nord_f1"	"Corpse"
"_MCAW_corpse_nord_f2"	"Corpse"
"_MCAW_corpse_nord_m1"	"Corpse"
"_MCAW_corpse_nord_m2"	"Corpse"
"_MCAW_corpse_orc_f1"	"Corpse"
"_MCAW_corpse_orc_f2"	"Corpse"
"_MCAW_corpse_orc_m1"	"Corpse"
"_MCAW_corpse_orc_m2"	"Corpse"
"_MCAW_corpse_redg_f1"	"Corpse"
"_MCAW_corpse_redg_f2"	"Corpse"
"_MCAW_corpse_redg_m1"	"Corpse"
"_MCAW_corpse_redg_m2"	"Corpse"
"_MCAW_crusader_altmer_f"	"Crusader"
"_MCAW_crusader_altmer_m"	"Crusader"
"_MCAW_crusader_bosmer_f"	"Crusader"
"_MCAW_crusader_bosmer_m"	"Crusader"
"_MCAW_crusader_breton_f"	"Crusader"
"_MCAW_crusader_breton_m"	"Crusader"
"_MCAW_crusader_dunmer_f"	"Crusader"
"_MCAW_crusader_dunmer_m"	"Crusader"
"_MCAW_crusader_imp_f"	"Crusader"
"_MCAW_crusader_imp_m"	"Crusader"
"_MCAW_crusader_nord_f"	"Crusader"
"_MCAW_crusader_nord_m"	"Crusader"
"_MCAW_fighter_altmer_f"	"Fighter"
"_MCAW_fighter_altmer_m"	"Fighter"
"_MCAW_fighter_argo_f"	"Fighter"
"_MCAW_fighter_argo_m"	"Fighter"
"_MCAW_fighter_bosmer_f"	"Fighter"
"_MCAW_fighter_bosmer_m"	"Fighter"
"_MCAW_fighter_breton_f"	"Fighter"
"_MCAW_fighter_breton_m"	"Fighter"
"_MCAW_fighter_dunmer_f"	"Fighter"
"_MCAW_fighter_dunmer_m"	"Fighter"
"_MCAW_fighter_imp_f"	"Fighter"
"_MCAW_fighter_imp_m"	"Fighter"
"_MCAW_fighter_khajiit_f"	"Fighter"
"_MCAW_fighter_khajiit_m"	"Fighter"
"_MCAW_fighter_nord_f"	"Fighter"
"_MCAW_fighter_nord_m"	"Fighter"
"_MCAW_fighter_orc_f"	"Fighter"
"_MCAW_fighter_orc_m"	"Fighter"
"_MCAW_fighter_redg_f"	"Fighter"
"_MCAW_fighter_redg_m"	"Fighter"
"_MCAW_imperial_archerf1"	"Imperial Archer"
"_MCAW_imperial_archerf2"	"Imperial Archer"
"_MCAW_imperial_archerf3"	"Imperial Archer"
"_MCAW_imperial_archerf4"	"Imperial Archer"
"_MCAW_imperial_archerm1"	"Imperial Archer"
"_MCAW_imperial_archerm2"	"Imperial Archer"
"_MCAW_imperial_archerm3"	"Imperial Archer"
"_MCAW_imperial_archerm4"	"Imperial Archer"
"_MCAW_imperial_archerm5"	"Imperial Archer"
"_MCAW_imperial_btlmage"	"Imperial Battlemage"
"_MCAW_imperial_captain"	"Imperial Centurion"
"_MCAW_imperial_champion"	"Imperial Champion"
"_MCAW_imperial_guard_f1"	"Imperial Legionary"
"_MCAW_imperial_guard_f2"	"Imperial Legionary"
"_MCAW_imperial_guard_f3"	"Imperial Legionary"
"_MCAW_imperial_guard_f4"	"Imperial Legionary"
"_MCAW_imperial_guard_m1"	"Imperial Legionary"
"_MCAW_imperial_guard_m2"	"Imperial Legionary"
"_MCAW_imperial_guard_m3"	"Imperial Legionary"
"_MCAW_imperial_guard_m4"	"Imperial Legionary"
"_MCAW_imperial_guard_m5"	"Imperial Legionary"
"_MCAW_imperial_knight"	"Imperial Knight"
"_MCAW_imperial_knight_f"	"Imperial Knight"
"_MCAW_imperial_marks_f1"	"Imperial Archer"
"_MCAW_imperial_marks_f2"	"Imperial Archer"
"_MCAW_imperial_marks_f3"	"Imperial Archer"
"_MCAW_imperial_marks_f4"	"Imperial Archer"
"_MCAW_imperial_marks_m1"	"Imperial Archer"
"_MCAW_imperial_marks_m2"	"Imperial Archer"
"_MCAW_imperial_marks_m3"	"Imperial Archer"
"_MCAW_imperial_marks_m4"	"Imperial Archer"
"_MCAW_imperial_marks_m5"	"Imperial Archer"
"_MCAW_imperial_spear1"	"Imperial Spearman"
"_MCAW_imperial_spear2"	"Imperial Spearman"
"_MCAW_imperial_spear3"	"Imperial Spearman"
"_MCAW_imperial_spear4"	"Imperial Spearman"
"_MCAW_imperial_spear5"	"Imperial Spearman"
"_MCAW_knight_altmer_f"	"Knight"
"_MCAW_knight_altmer_m"	"Knight"
"_MCAW_knight_breton_f"	"Knight"
"_MCAW_knight_breton_m"	"Knight"
"_MCAW_knight_dunmer_f"	"Knight"
"_MCAW_knight_dunmer_m"	"Knight"
"_MCAW_knight_imperial_f"	"Knight"
"_MCAW_knight_imperial_m"	"Knight"
"_MCAW_knight_nord_f"	"Knight"
"_MCAW_knight_nord_m"	"Knight"
"_MCAW_mabrigash_05a"	"Mabrigash"
"_MCAW_mabrigash_05b"	"Mabrigash"
"_MCAW_mabrigash_05c"	"Mabrigash"
"_MCAW_mabrigash_05d"	"Mabrigash"
"_MCAW_mabrigash_05e"	"Mabrigash"
"_MCAW_mabrigash_05f"	"Mabrigash"
"_MCAW_mabrigash_10a"	"Mabrigash"
"_MCAW_mabrigash_10b"	"Mabrigash"
"_MCAW_mabrigash_10c"	"Mabrigash"
"_MCAW_mabrigash_10d"	"Mabrigash"
"_MCAW_mabrigash_10e"	"Mabrigash"
"_MCAW_mabrigash_10f"	"Mabrigash"
"_MCAW_mabrigash_20a"	"Mabrigash"
"_MCAW_mabrigash_20b"	"Mabrigash"
"_MCAW_mabrigash_20c"	"Mabrigash"
"_MCAW_mabrigash_20d"	"Mabrigash"
"_MCAW_mabrigash_20e"	"Mabrigash"
"_MCAW_mabrigash_20f"	"Mabrigash"
"_MCAW_mage_altmer_f"	"Mage"
"_MCAW_mage_altmer_m"	"Mage"
"_MCAW_mage_argonian_f"	"Mage"
"_MCAW_mage_argonian_m"	"Mage"
"_MCAW_mage_bosmer_f"	"Mage"
"_MCAW_mage_bosmer_m"	"Mage"
"_MCAW_mage_breton_f"	"Mage"
"_MCAW_mage_breton_m"	"Mage"
"_MCAW_mage_dunmer_f"	"Mage"
"_MCAW_mage_dunmer_m"	"Mage"
"_MCAW_mage_imperial_f"	"Mage"
"_MCAW_mage_imperial_m"	"Mage"
"_MCAW_mage_khajiit_f"	"Mage"
"_MCAW_mage_khajiit_m"	"Mage"
"_MCAW_mage_redguard_f"	"Mage"
"_MCAW_mage_redguard_m"	"Mage"
"_MCAW_ordinator"	"Ordinator"
"_MCAW_ordinator_dead"	"Dead Ordinator"
"_MCAW_ordinator_elite"	"Elite Ordinator"
"_MCAW_ordinator_female"	"Ordinator"
"_MCAW_outlaw15_altmer_f"	"Outlaw"
"_MCAW_outlaw15_altmer_m"	"Outlaw"
"_MCAW_outlaw15_bosmer_f"	"Outlaw"
"_MCAW_outlaw15_bosmer_m"	"Outlaw"
"_MCAW_outlaw15_breton_f"	"Outlaw"
"_MCAW_outlaw15_breton_m"	"Outlaw"
"_MCAW_outlaw15_dunmer_f"	"Outlaw"
"_MCAW_outlaw15_dunmer_m"	"Outlaw"
"_MCAW_outlaw15_imp_f"	"Outlaw"
"_MCAW_outlaw15_imp_m"	"Outlaw"
"_MCAW_outlaw15_nord_f"	"Outlaw"
"_MCAW_outlaw15_nord_m"	"Outlaw"
"_MCAW_outlaw15_orc_f"	"Outlaw"
"_MCAW_outlaw15_orc_m"	"Outlaw"
"_MCAW_outlaw15_redgrd_f"	"Outlaw"
"_MCAW_outlaw15_redgrd_m"	"Outlaw"
"_MCAW_outlaw20_altmer_f"	"Outlaw"
"_MCAW_outlaw20_altmer_m"	"Outlaw"
"_MCAW_outlaw20_bosmer_f"	"Outlaw"
"_MCAW_outlaw20_bosmer_m"	"Outlaw"
"_MCAW_outlaw20_breton_f"	"Outlaw"
"_MCAW_outlaw20_breton_m"	"Outlaw"
"_MCAW_outlaw20_dunmer_f"	"Outlaw"
"_MCAW_outlaw20_dunmer_m"	"Outlaw"
"_MCAW_outlaw20_imp_f"	"Outlaw"
"_MCAW_outlaw20_imp_m"	"Outlaw"
"_MCAW_outlaw20_nord_f"	"Outlaw"
"_MCAW_outlaw20_nord_m"	"Outlaw"
"_MCAW_outlaw20_orc_f"	"Outlaw"
"_MCAW_outlaw20_orc_m"	"Outlaw"
"_MCAW_outlaw20_redg_f"	"Outlaw"
"_MCAW_outlaw20_redg_m"	"Outlaw"
"_MCAW_outlaw30_altmer_f"	"Outlaw"
"_MCAW_outlaw30_altmer_m"	"Outlaw"
"_MCAW_outlaw30_breton_f"	"Outlaw"
"_MCAW_outlaw30_breton_m"	"Outlaw"
"_MCAW_outlaw30_dunmer_f"	"Outlaw"
"_MCAW_outlaw30_dunmer_m"	"Outlaw"
"_MCAW_outlaw30_imp_f"	"Outlaw"
"_MCAW_outlaw30_imp_m"	"Outlaw"
"_MCAW_outlaw30_nord_f"	"Outlaw"
"_MCAW_outlaw30_nord_m"	"Outlaw"
"_MCAW_outlaw30_orc_f"	"Outlaw"
"_MCAW_outlaw30_orc_m"	"Outlaw"
"_MCAW_outlaw30_redg_f"	"Outlaw"
"_MCAW_outlaw30_redg_m"	"Outlaw"
"_MCAW_outlaw40_altmer_f"	"Outlaw"
"_MCAW_outlaw40_altmer_m"	"Outlaw"
"_MCAW_outlaw40_bosmer_f"	"Outlaw"
"_MCAW_outlaw40_bosmer_m"	"Outlaw"
"_MCAW_outlaw40_breton_f"	"Outlaw"
"_MCAW_outlaw40_breton_m"	"Outlaw"
"_MCAW_outlaw40_dunmer_f"	"Outlaw"
"_MCAW_outlaw40_dunmer_m"	"Outlaw"
"_MCAW_outlaw40_imp_f"	"Outlaw"
"_MCAW_outlaw40_imp_m"	"Outlaw"
"_MCAW_outlaw40_nord_f"	"Outlaw"
"_MCAW_outlaw40_nord_m"	"Outlaw"
"_MCAW_outlaw40_orc_f1"	"Outlaw"
"_MCAW_outlaw40_orc_f2"	"Outlaw"
"_MCAW_outlaw40_orc_m1"	"Outlaw"
"_MCAW_outlaw40_orc_m2"	"Outlaw"
"_MCAW_outlaw40_redg_f"	"Outlaw"
"_MCAW_outlaw40_redg_m"	"Outlaw"
"_MCAW_outlaw50_altmer_f"	"Outlaw"
"_MCAW_outlaw50_altmer_m"	"Outlaw"
"_MCAW_outlaw50_bosmer_f"	"Outlaw"
"_MCAW_outlaw50_bosmer_m"	"Outlaw"
"_MCAW_outlaw50_breton_f"	"Outlaw"
"_MCAW_outlaw50_breton_m"	"Outlaw"
"_MCAW_outlaw50_dunmer_f"	"Outlaw"
"_MCAW_outlaw50_dunmer_m"	"Outlaw"
"_MCAW_outlaw50_imp_f"	"Outlaw"
"_MCAW_outlaw50_imp_m"	"Outlaw"
"_MCAW_outlaw50_nord_f"	"Outlaw"
"_MCAW_outlaw50_nord_m"	"Outlaw"
"_MCAW_outlaw50_orc_f"	"Outlaw"
"_MCAW_outlaw50_orc_m"	"Outlaw"
"_MCAW_outlaw50_redg_f"	"Outlaw"
"_MCAW_outlaw50_redg_m"	"Outlaw"
"_MCAW_ranger_altmer"	"Ranger"
"_MCAW_ranger_bosmer"	"Ranger"
"_MCAW_ranger_breton"	"Ranger"
"_MCAW_ranger_dunmer"	"Ranger"
"_MCAW_ranger_imperial"	"Ranger"
"_MCAW_ranger_nord"	"Ranger"
"_MCAW_rogue_bosmer_f"	"Rogue"
"_MCAW_rogue_bosmer_m"	"Rogue"
"_MCAW_rogue_breton_f"	"Rogue"
"_MCAW_rogue_breton_m"	"Rogue"
"_MCAW_rogue_dunmer_f"	"Rogue"
"_MCAW_rogue_dunmer_m"	"Rogue"
"_MCAW_rogue_imperial_f"	"Rogue"
"_MCAW_rogue_imperial_m"	"Rogue"
"_MCAW_rogue_khajiit_f"	"Rogue"
"_MCAW_rogue_khajiit_m"	"Rogue"
"_MCAW_rogue_redguard_f"	"Rogue"
"_MCAW_rogue_redguard_m"	"Rogue"
"_MCAW_ruffian_bosmer_f"	"Ruffian"
"_MCAW_ruffian_bosmer_m"	"Ruffian"
"_MCAW_ruffian_breton_f"	"Ruffian"
"_MCAW_ruffian_breton_m"	"Ruffian"
"_MCAW_ruffian_dunmer_f"	"Ruffian"
"_MCAW_ruffian_dunmer_m"	"Ruffian"
"_MCAW_ruffian_imp_f"	"Ruffian"
"_MCAW_ruffian_imp_m"	"Ruffian"
"_MCAW_ruffian_khajiit_f"	"Ruffian"
"_MCAW_ruffian_khajiit_m"	"Ruffian"
"_MCAW_ruffian_nord_f"	"Ruffian"
"_MCAW_ruffian_nord_m"	"Ruffian"
"_MCAW_ruffian_orc_f"	"Ruffian"
"_MCAW_ruffian_orc_m"	"Ruffian"
"_MCAW_ruffian_redgrd_f"	"Ruffian"
"_MCAW_ruffian_redgrd_m"	"Ruffian"
"_MCAW_soldier_hlaalu_c"	"Hlaalu Captain"
"_MCAW_soldier_hlaalu_f"	"Hlaalu Soldier"
"_MCAW_soldier_hlaalu_m"	"Hlaalu Soldier"
"_MCAW_soldier_redoran_c"	"Redoran Captain"
"_MCAW_soldier_redoran_f"	"Redoran Soldier"
"_MCAW_soldier_redoran_m"	"Redoran Soldier"
"_MCAW_soldier_telvann_c"	"Telvanni Captain"
"_MCAW_soldier_telvann_f"	"Telvanni Soldier"
"_MCAW_soldier_telvann_m"	"Telvanni Soldier"
"_MCAW_thief_bosmer_f"	"Thief"
"_MCAW_thief_bosmer_m"	"Thief"
"_MCAW_thief_breton_f"	"Thief"
"_MCAW_thief_breton_m"	"Thief"
"_MCAW_thief_dunmer_f"	"Thief"
"_MCAW_thief_dunmer_m"	"Thief"
"_MCAW_thief_imp_f"	"Thief"
"_MCAW_thief_imp_m"	"Thief"
"_MCAW_thief_khajiit_f"	"Thief"
"_MCAW_thief_khajiit_m"	"Thief"
"_MCAW_thief_redg_f"	"Thief"
"_MCAW_thief_redg_m"	"Thief"
"_MCAW_traveller_alt_f"	"Traveler"
"_MCAW_traveller_alt_m"	"Traveler"
"_MCAW_traveller_argo_f"	"Traveler"
"_MCAW_traveller_argo_m"	"Traveler"
"_MCAW_traveller_bos_f1"	"Traveler"
"_MCAW_traveller_bos_f2"	"Traveler"
"_MCAW_traveller_bos_m1"	"Traveler"
"_MCAW_traveller_bos_m2"	"Traveler"
"_MCAW_traveller_bret_f1"	"Traveler"
"_MCAW_traveller_bret_f2"	"Traveler"
"_MCAW_traveller_bret_m1"	"Traveler"
"_MCAW_traveller_bret_m2"	"Traveler"
"_MCAW_traveller_dunm_f1"	"Traveler"
"_MCAW_traveller_dunm_f2"	"Traveler"
"_MCAW_traveller_dunm_m1"	"Traveler"
"_MCAW_traveller_dunm_m2"	"Traveler"
"_MCAW_traveller_imp_f1"	"Traveler"
"_MCAW_traveller_imp_f2"	"Traveler"
"_MCAW_traveller_imp_m1"	"Traveler"
"_MCAW_traveller_imp_m2"	"Traveler"
"_MCAW_traveller_khaj_f"	"Traveler"
"_MCAW_traveller_khaj_m"	"Traveler"
"_MCAW_traveller_nord_f1"	"Traveler"
"_MCAW_traveller_nord_f2"	"Traveler"
"_MCAW_traveller_nord_m1"	"Traveler"
"_MCAW_traveller_nord_m2"	"Traveler"
"_MCAW_traveller_orc_f"	"Traveler"
"_MCAW_traveller_orc_m"	"Traveler"
"_MCAW_traveller_redg_f"	"Traveler"
"_MCAW_traveller_redg_m"	"Traveler"
"_MCAW_war_dunmer_bone_f"	"Warrior"
"_MCAW_war_dunmer_bone_m"	"Warrior"
"_MCAW_warlock_altm_m"	"Warlock"
"_MCAW_warlock_bosm_m"	"Warlock"
"_MCAW_warlock_bret_m"	"Warlock"
"_MCAW_warlock_dunm_m"	"Warlock"
"_MCAW_warlock_imp_m"	"Warlock"
"_MCAW_warlock_nord_m"	"Warlock"
"_MCAW_warlock_orc_m"	"Warlock"
"_MCAW_warlock_redg_m"	"Warlock"
"_MCAW_warrior_altmer_f"	"Warrior"
"_MCAW_warrior_altmer_m"	"Warrior"
"_MCAW_warrior_argonia_f"	"Warrior"
"_MCAW_warrior_argonia_m"	"Warrior"
"_MCAW_warrior_bosmer_f"	"Warrior"
"_MCAW_warrior_bosmer_m"	"Warrior"
"_MCAW_warrior_breton_f"	"Warrior"
"_MCAW_warrior_breton_m"	"Warrior"
"_MCAW_warrior_dunmer_f"	"Warrior"
"_MCAW_warrior_dunmer_m"	"Warrior"
"_MCAW_warrior_imperia_f"	"Warrior"
"_MCAW_warrior_imperia_m"	"Warrior"
"_MCAW_warrior_khajiit_f"	"Warrior"
"_MCAW_warrior_khajiit_m"	"Warrior"
"_MCAW_warrior_nord_f"	"Warrior"
"_MCAW_warrior_nord_m"	"Warrior"
"_MCAW_warrior_orc_f"	"Warrior"
"_MCAW_warrior_orc_m"	"Warrior"
"_MCAW_warrior_redguar_f"	"Warrior"
"_MCAW_warrior_redguar_m"	"Warrior"
"_MCAW_witch_altm_f"	"Witch"
"_MCAW_witch_bosm_f"	"Witch"
"_MCAW_witch_bret_f"	"Witch"
"_MCAW_witch_dunm_f"	"Witch"
"_MCAW_witch_imp_f"	"Witch"
"_MCAW_witch_nord_f"	"Witch"
"_MCAW_witch_orc_f"	"Witch"
"_MCAW_witch_redg_f"	"Witch"
"_NP_00_ghost"	"Ghost"
"_NP_05_n_phan_berserker"	"Phantom Berserker"
"_NP_05_n_phantom"	"Phantom"
"_NP_05_n_skel"	"Skeleton"
"_NP_05_n_skel_berserker"	"Skeleton Berserker"
"_NP_05_phan"	"Phantom"
"_NP_05_phan_bowman"	"Phantom Bowman"
"_NP_05_skel"	"Skeleton"
"_NP_05_skel_bowman"	"Skeleton Bowman"
"_NP_05_skel_crip_01"	"Crippled Skeleton"
"_NP_05_skel_crip_02"	"Crippled Skeleton"
"_NP_05_skel_crip_03"	"Crippled Skeleton"
"_NP_05_skel_crip_04"	"Crippled Skeleton"
"_NP_05_skel_crip_05"	"Crippled Skeleton"
"_NP_05_skel_crip_06"	"Crippled Skeleton"
"_NP_05_skel_crip_07"	"Crippled Skeleton"
"_NP_05_skel_crip_08"	"Crippled Skeleton"
"_NP_05_skel_crip_09"	"Crippled Skeleton"
"_NP_05_skel_crip_10"	"Crippled Skeleton"
"_NP_05_skel_crip_11"	"Crippled Skeleton"
"_NP_10_n_phan_fighter"	"Phantom Fighter"
"_NP_10_n_phan_reaver"	"Phantom Reaver"
"_NP_10_n_phan_reaver_a"	"Phantom Reaver"
"_NP_10_n_phan_shaman"	"Phantom Shaman"
"_NP_10_n_skel_fighter"	"Skeleton Fighter"
"_NP_10_n_skel_reaver"	"Skeleton Reaver"
"_NP_10_n_skel_reaver_a"	"Skeleton Reaver"
"_NP_10_n_skel_shaman"	"Skeleton Shaman"
"_NP_10_phan_archer"	"Phantom Archer"
"_NP_10_phan_fighter"	"Phantom Fighter"
"_NP_10_phan_mage"	"Phantom Mage"
"_NP_10_skel_archer"	"Skeleton Archer"
"_NP_10_skel_fighter"	"Skeleton Fighter"
"_NP_10_skel_mage"	"Skeleton Mage"
"_NP_100_n_phan_reaver"	"Ancient Phantom Reaver"
"_NP_100_n_phan_reaver_a"	"Ancient Phantom Reaver"
"_NP_100_n_skel_reaver"	"Ancient Skeleton Reaver"
"_NP_100_n_skel_reaver_a"	"Ancient Skeleton Reaver"
"_NP_100_phan_marksman"	"Ancient Phantom Marksman"
"_NP_100_phan_sorceror"	"Ancient Phantom Sorceror"
"_NP_100_skel_marksman"	"Ancient Skeleton Marksman"
"_NP_100_skel_sorceror"	"Ancient Skeleton Sorceror"
"_NP_125_n_phan_champion"	"Ancient Phantom Champion"
"_NP_125_n_skel_champion"	"Ancient Skeleton Champion"
"_NP_125_phan_champion"	"Ancient Phantom Champion"
"_NP_125_phan_crusader"	"Ancient Phantom Crusader"
"_NP_125_skel_champion"	"Ancient Skeleton Champion"
"_NP_125_skel_crusader"	"Ancient Skeleton Crusader"
"_NP_15_n_phan_berserker"	"Phantom Berserker"
"_NP_15_n_phan_warrior"	"Phantom Warrior"
"_NP_15_n_skel_berserker"	"Skeleton Berserker"
"_NP_15_n_skel_warrior"	"Skeleton Warrior"
"_NP_15_phan_knight"	"Phantom Knight"
"_NP_15_phan_warrior"	"Phantom Warrior"
"_NP_15_skel_knight"	"Skeleton Knight"
"_NP_15_skel_warrior"	"Skeleton Warrior"
"_NP_150_n_phan_berserk"	"Ancient Phantom Berserker"
"_NP_150_n_skel_berserk"	"Ancient Skeleton Berserker"
"_NP_150_wraith"	"Ancient Wraith"
"_NP_175_n_phan_hero"	"Ancient Phantom Hero"
"_NP_175_n_skel_hero"	"Ancient Skeleton Hero"
"_NP_175_phan_hero"	"Ancient Phantom Hero"
"_NP_175_phan_sharp"	"Ancient Phantom Sharpshooter"
"_NP_175_phan_warlock"	"Ancient Phantom Warlock"
"_NP_175_skel_hero"	"Ancient Skeleton Hero"
"_NP_175_skel_sharp"	"Ancient Skeleton Sharpshooter"
"_NP_175_skel_warlock"	"Ancient Skeleton Warlock"
"_NP_20_n_phan_reaver"	"Phantom Reaver"
"_NP_20_n_phan_reaver_a"	"Phantom Reaver"
"_NP_20_n_skel_reaver"	"Skeleton Reaver"
"_NP_20_n_skel_reaver_a"	"Skeleton Reaver"
"_NP_20_phan_marksman"	"Phantom Marksman"
"_NP_20_phan_sorceror"	"Phantom Sorceror"
"_NP_20_skel_marksman"	"Skeleton Marksman"
"_NP_20_skel_sorceror"	"Skeleton Sorceror"
"_NP_200_haunt"	"Ancient Haunt"
"_NP_200_lich_lord"	"Ancient Lich Lord"
"_NP_200_wraith_lord"	"Ancient Wraith Lord"
"_NP_25_n_phan_champion"	"Phantom Champion"
"_NP_25_n_skel_champion"	"Skeleton Champion"
"_NP_25_phan_champion"	"Phantom Champion"
"_NP_25_phan_crusader"	"Phantom Crusader"
"_NP_25_skel_champion"	"Skeleton Champion"
"_NP_25_skel_crusader"	"Skeleton Crusader"
"_NP_25_wraith"	"Wraith"
"_NP_30_n_phan_berserker"	"Phantom Berserker"
"_NP_30_n_skel_berserker"	"Skeleton Berserker"
"_NP_40_n_phan_hero"	"Phantom Hero"
"_NP_40_n_skel_hero"	"Skeleton Hero"
"_NP_40_phan_hero"	"Phantom Hero"
"_NP_40_phan_sharp"	"Phantom Sharpshooter"
"_NP_40_phan_warlock"	"Phantom Warlock"
"_NP_40_skel_hero"	"Skeleton Hero"
"_NP_40_skel_sharp"	"Skeleton Sharpshooter"
"_NP_40_skel_warlock"	"Skeleton Warlock"
"_NP_50_haunt"	"Haunt"
"_NP_50_lich_lord"	"Lich Lord"
"_NP_50_n_phan_berserker"	"Phantom Berserker"
"_NP_50_n_skel_berserker"	"Skeleton Berserker"
"_NP_50_wraith_lord"	"Wraith Lord"
"_NP_75_n_phan_berserker"	"Ancient Phantom Berserker"
"_NP_75_n_phantom"	"Ancient Phantom"
"_NP_75_n_skel"	"Ancient Skeleton"
"_NP_75_n_skel_berserker"	"Ancient Skeleton Berserker"
"_NP_75_phan"	"Ancient Phantom"
"_NP_75_phan_bowman"	"Ancient Phantom Bowman"
"_NP_75_skel"	"Ancient Skeleton"
"_NP_75_skel_bowman"	"Ancient Skeleton Bowman"
"_NP_80_n_phan_fighter"	"Ancient Phantom Fighter"
"_NP_80_n_phan_reaver"	"Ancient Phantom Reaver"
"_NP_80_n_phan_reaver_a"	"Ancient Phantom Reaver"
"_NP_80_n_phan_shaman"	"Ancient Phantom Shaman"
"_NP_80_n_skel_fighter"	"Ancient Skeleton Fighter"
"_NP_80_n_skel_reaver"	"Ancient Skeleton Reaver"
"_NP_80_n_skel_reaver_a"	"Ancient Skeleton Reaver"
"_NP_80_n_skel_shaman"	"Ancient Skeleton Shaman"
"_NP_80_phan_archer"	"Ancient Phantom Archer"
"_NP_80_phan_fighter"	"Ancient Phantom Fighter"
"_NP_80_phan_mage"	"Ancient Phantom Mage"
"_NP_80_skel_archer"	"Ancient Skeleton Archer"
"_NP_80_skel_fighter"	"Ancient Skeleton Fighter"
"_NP_80_skel_mage"	"Ancient Skeleton Mage"
"_NP_90_n_phan_berserker"	"Ancient Phantom Berserker"
"_NP_90_n_phan_warrior"	"Ancient Phantom Warrior"
"_NP_90_n_skel_berserker"	"Ancient Skeleton Berserker"
"_NP_90_n_skel_warrior"	"Ancient Skeleton Warrior"
"_NP_90_phan_knight"	"Ancient Phantom Knight"
"_NP_90_phan_warrior"	"Ancient Phantom Warrior"
"_NP_90_skel_knight"	"Ancient Skeleton Knight"
"_NP_90_skel_warrior"	"Ancient Skeleton Warrior"
